"a" = (/turf/template_noop,/area/template_noop)
"b" = (/turf/closed/wall/shuttle/smooth/nodiagonal,/area/ruin/powered)
"c" = (/turf/closed/wall/shuttle/interior,/area/ruin/powered)
"d" = (/obj/machinery/door/airlock/external,/turf/open/floor/plasteel/shuttle/red/syndicate,/area/ruin/powered)
"e" = (/obj/effect/decal/cleanable/blood,/obj/effect/mob_spawn/human/corpse/syndicatesoldier,/turf/open/floor/plasteel/shuttle/red/syndicate,/area/ruin/powered)
"f" = (/obj/item/ammo_casing/a762,/turf/open/floor/plasteel/podhatch,/area/ruin/powered)
"g" = (/obj/effect/decal/cleanable/xenoblood,/obj/machinery/light{dir = 1},/obj/item/weapon/tank/internals/oxygen,/turf/open/floor/plasteel/shuttle/red/syndicate,/area/ruin/powered)
"h" = (/turf/closed/wall/shuttle/smooth,/area/ruin/powered)
"i" = (/obj/machinery/door/airlock/hatch,/turf/open/floor/plasteel/shuttle/red/syndicate,/area/ruin/powered)
"j" = (/obj/structure/chair,/turf/open/floor/plasteel/shuttle/red/syndicate,/area/ruin/powered)
"k" = (/turf/open/floor/plasteel/shuttle/red/syndicate,/area/ruin/powered)
"l" = (/obj/effect/decal/cleanable/blood,/obj/item/chair,/obj/effect/mob_spawn/human/corpse/syndicatesoldier,/turf/open/floor/plasteel/shuttle/red/syndicate,/area/ruin/powered)
"m" = (/obj/item/trash/syndi_cakes,/turf/open/floor/plasteel/shuttle/red/syndicate,/area/ruin/powered)
"n" = (/obj/effect/decal/cleanable/blood,/turf/open/floor/plasteel/shuttle/red/syndicate,/area/ruin/powered)
"o" = (/obj/effect/decal/cleanable/xenoblood,/turf/open/floor/plasteel/shuttle/red/syndicate,/area/ruin/powered)
"p" = (/obj/machinery/light{dir = 4; icon_state = "tube1"},/turf/open/floor/plasteel/shuttle/red/syndicate,/area/ruin/powered)
"q" = (/obj/machinery/light{icon_state = "tube1"; dir = 8},/turf/open/floor/plasteel/shuttle/red/syndicate,/area/ruin/powered)
"r" = (/mob/living/simple_animal/hostile/alien/sentinel,/turf/open/floor/plasteel/shuttle/red/syndicate,/area/ruin/powered)
"s" = (/obj/effect/decal/cleanable/blood,/obj/item/ammo_box/magazine/pistolm9mm,/obj/effect/mob_spawn/human/corpse/syndicatesoldier,/turf/open/floor/plasteel/shuttle/red/syndicate,/area/ruin/powered)
"t" = (/obj/item/chair,/turf/open/floor/plasteel/shuttle/red/syndicate,/area/ruin/powered)
"u" = (/obj/structure/closet/crate,/obj/item/clothing/glasses/meson/night,/obj/item/toy/nuke,/obj/item/toy/figure/syndie,/turf/open/floor/plasteel/shuttle/red/syndicate,/area/ruin/powered)
"v" = (/obj/structure/table,/obj/item/weapon/gun/projectile/automatic/pistol,/turf/open/floor/plasteel/shuttle/red/syndicate,/area/ruin/powered)
"w" = (/obj/structure/shuttle/engine/propulsion,/turf/open/space,/area/ruin/powered)

(1,1,1) = {"
aabcdcbaaa
aacefgcaaa
abhhihhbaa
acjjkjlhaa
acmnokphaa
acqkrnkhaa
ahstuovhaa
abhhhhhbaa
aawaaawaaa
aaaaaaaaaa
"}
