//MAP CONVERTED BY dmm2tgm.py THIS HEADER COMMENT PREVENTS RECONVERSION, DO NOT REMOVE 
"aa" = (
/turf/template_noop,
/area/template_noop)
"ae" = (
/turf/closed/wall/shuttle/smooth{
	baseturf = /turf/open/floor/plating/lava/smooth/lava_land_surface
	},
/area/ruin/powered)
"af" = (
/obj/structure/grille,
/obj/structure/window/fulltile,
/turf/open/floor/plating{
	baseturf = /turf/open/floor/plating/lava/smooth/lava_land_surface
	},
/area/ruin/powered)
"ag" = (
/turf/open/floor/plasteel/bar{
	baseturf = /turf/open/floor/plating/lava/smooth/lava_land_surface
	},
/area/ruin/powered)
"ah" = (
/obj/structure/toilet,
/turf/open/floor/plasteel/bar{
	baseturf = /turf/open/floor/plating/lava/smooth/lava_land_surface
	},
/area/ruin/powered)
"ai" = (
/obj/machinery/vending/coffee,
/turf/open/floor/plasteel/cmo{
	baseturf = /turf/open/floor/plating/lava/smooth/lava_land_surface
	},
/area/ruin/powered)
"aj" = (
/obj/structure/table/wood,
/obj/item/device/flashlight/lamp,
/turf/open/floor/plasteel/cmo{
	baseturf = /turf/open/floor/plating/lava/smooth/lava_land_surface
	},
/area/ruin/powered)
"ak" = (
/obj/structure/table/wood,
/obj/item/device/taperecorder,
/obj/item/weapon/pen/blue,
/turf/open/floor/plasteel/cmo{
	baseturf = /turf/open/floor/plating/lava/smooth/lava_land_surface
	},
/area/ruin/powered)
"al" = (
/obj/structure/table/wood,
/obj/item/toy/carpplushie,
/turf/open/floor/plasteel/cmo{
	baseturf = /turf/open/floor/plating/lava/smooth/lava_land_surface
	},
/area/ruin/powered)
"am" = (
/obj/machinery/vending/snack,
/turf/open/floor/plasteel/cmo{
	baseturf = /turf/open/floor/plating/lava/smooth/lava_land_surface
	},
/area/ruin/powered)
"an" = (
/obj/machinery/sleeper{
	icon_state = "sleeper-open";
	dir = 4
	},
/turf/open/floor/plasteel/white{
	baseturf = /turf/open/floor/plating/lava/smooth/lava_land_surface
	},
/area/ruin/powered)
"ao" = (
/turf/open/floor/plasteel/white{
	baseturf = /turf/open/floor/plating/lava/smooth/lava_land_surface
	},
/area/ruin/powered)
"ap" = (
/obj/structure/table,
/obj/item/weapon/circular_saw,
/obj/item/weapon/scalpel{
	pixel_y = 12
	},
/turf/open/floor/plasteel/white{
	baseturf = /turf/open/floor/plating/lava/smooth/lava_land_surface
	},
/area/ruin/powered)
"aq" = (
/obj/structure/table,
/obj/item/weapon/cautery{
	pixel_x = 4
	},
/obj/item/weapon/surgicaldrill,
/turf/open/floor/plasteel/white{
	baseturf = /turf/open/floor/plating/lava/smooth/lava_land_surface
	},
/area/ruin/powered)
"ar" = (
/obj/structure/table,
/obj/item/weapon/surgical_drapes,
/obj/item/weapon/razor,
/turf/open/floor/plasteel/white{
	baseturf = /turf/open/floor/plating/lava/smooth/lava_land_surface
	},
/area/ruin/powered)
"as" = (
/turf/open/floor/plasteel/cmo{
	baseturf = /turf/open/floor/plating/lava/smooth/lava_land_surface
	},
/area/ruin/powered)
"at" = (
/obj/structure/chair/office/dark{
	dir = 1
	},
/turf/open/floor/plasteel/cmo{
	baseturf = /turf/open/floor/plating/lava/smooth/lava_land_surface
	},
/area/ruin/powered)
"au" = (
/obj/structure/chair/office/dark{
	dir = 4
	},
/turf/open/floor/plasteel/cmo{
	baseturf = /turf/open/floor/plating/lava/smooth/lava_land_surface
	},
/area/ruin/powered)
"av" = (
/obj/item/weapon/reagent_containers/glass/rag,
/obj/item/weapon/reagent_containers/spray/cleaner,
/turf/open/floor/plasteel/blue/side{
	baseturf = /turf/open/floor/plating/lava/smooth/lava_land_surface;
	dir = 8
	},
/area/ruin/powered)
"aw" = (
/obj/structure/bed/roller,
/turf/open/floor/plasteel/white{
	baseturf = /turf/open/floor/plating/lava/smooth/lava_land_surface
	},
/area/ruin/powered)
"ay" = (
/obj/structure/sink{
	icon_state = "sink";
	dir = 8;
	pixel_x = -12;
	pixel_y = 2
	},
/obj/structure/mirror{
	pixel_x = -28
	},
/turf/open/floor/plasteel/bar{
	baseturf = /turf/open/floor/plating/lava/smooth/lava_land_surface
	},
/area/ruin/powered)
"az" = (
/obj/structure/noticeboard{
	dir = 1;
	pixel_y = -27
	},
/obj/item/weapon/paper{
	info = "Nothing of interest to report.";
	name = "Important Notice - Mrs. Henderson"
	},
/turf/open/floor/plasteel/cmo{
	baseturf = /turf/open/floor/plating/lava/smooth/lava_land_surface
	},
/area/ruin/powered)
"aA" = (
/obj/structure/closet/secure_closet/medical2,
/turf/open/floor/plasteel/white{
	baseturf = /turf/open/floor/plating/lava/smooth/lava_land_surface
	},
/area/ruin/powered)
"aB" = (
/obj/machinery/computer/operating,
/turf/open/floor/plasteel/white{
	baseturf = /turf/open/floor/plating/lava/smooth/lava_land_surface
	},
/area/ruin/powered)
"aC" = (
/obj/structure/table/optable,
/turf/open/floor/plasteel/white{
	baseturf = /turf/open/floor/plating/lava/smooth/lava_land_surface
	},
/area/ruin/powered)
"aD" = (
/obj/structure/table,
/obj/item/weapon/retractor,
/obj/item/weapon/hemostat,
/turf/open/floor/plasteel/white{
	baseturf = /turf/open/floor/plating/lava/smooth/lava_land_surface
	},
/area/ruin/powered)
"aE" = (
/turf/closed/wall/shuttle/smooth/nodiagonal{
	baseturf = /turf/open/floor/plating/lava/smooth/lava_land_surface
	},
/area/ruin/powered)
"aF" = (
/obj/machinery/door/unpowered/shuttle{
	name = "Restroom"
	},
/turf/open/floor/plasteel/bar{
	baseturf = /turf/open/floor/plating/lava/smooth/lava_land_surface
	},
/area/ruin/powered)
"aG" = (
/obj/structure/extinguisher_cabinet,
/turf/closed/wall/shuttle/smooth{
	baseturf = /turf/open/floor/plating/lava/smooth/lava_land_surface
	},
/area/ruin/powered)
"aH" = (
/obj/structure/extinguisher_cabinet,
/turf/closed/wall/shuttle/smooth/nodiagonal{
	baseturf = /turf/open/floor/plating/lava/smooth/lava_land_surface
	},
/area/ruin/powered)
"aI" = (
/turf/closed/wall/shuttle/smooth,
/area/ruin/powered)
"aK" = (
/turf/open/floor/plasteel{
	baseturf = /turf/open/floor/plating/lava/smooth/lava_land_surface
	},
/area/ruin/powered)
"aL" = (
/turf/open/floor/plasteel/blue/side{
	baseturf = /turf/open/floor/plating/lava/smooth/lava_land_surface;
	dir = 1
	},
/area/ruin/powered)
"aM" = (
/obj/effect/mob_spawn/human/doctor/alive/lavaland,
/turf/open/floor/plasteel/blue/side{
	baseturf = /turf/open/floor/plating/lava/smooth/lava_land_surface;
	dir = 1
	},
/area/ruin/powered)
"aN" = (
/obj/structure/closet/crate/freezer,
/obj/item/weapon/reagent_containers/blood/random,
/obj/item/weapon/reagent_containers/blood/random,
/obj/item/weapon/reagent_containers/blood/random,
/obj/item/weapon/reagent_containers/blood/random,
/turf/open/floor/plasteel/blue/side{
	baseturf = /turf/open/floor/plating/lava/smooth/lava_land_surface;
	dir = 1
	},
/area/ruin/powered)
"aO" = (
/obj/machinery/iv_drip,
/turf/open/floor/plasteel/blue/side{
	baseturf = /turf/open/floor/plating/lava/smooth/lava_land_surface;
	dir = 1
	},
/area/ruin/powered)
"aP" = (
/turf/open/floor/plasteel/blue/side{
	baseturf = /turf/open/floor/plating/lava/smooth/lava_land_surface;
	dir = 0
	},
/area/ruin/powered)
"aQ" = (
/turf/open/floor/plasteel/blue/corner{
	baseturf = /turf/open/floor/plating/lava/smooth/lava_land_surface;
	dir = 8
	},
/area/ruin/powered)
"aR" = (
/turf/open/floor/plasteel/blue/side{
	baseturf = /turf/open/floor/plating/lava/smooth/lava_land_surface;
	dir = 4
	},
/area/ruin/powered)
"aS" = (
/turf/open/floor/plasteel/blue/side{
	baseturf = /turf/open/floor/plating/lava/smooth/lava_land_surface;
	dir = 8
	},
/area/ruin/powered)
"aT" = (
/obj/structure/closet,
/obj/effect/decal/cleanable/cobweb,
/obj/item/ammo_casing/shotgun/dart,
/obj/item/ammo_casing/shotgun/dart,
/obj/item/weapon/gun/projectile/revolver/doublebarrel{
	desc = "For putting critters out to pasture."
	},
/obj/item/ammo_casing/shotgun/buckshot,
/obj/item/weapon/storage/box/bodybags,
/turf/open/floor/plating{
	baseturf = /turf/open/floor/plating/lava/smooth/lava_land_surface
	},
/area/ruin/powered)
"aU" = (
/turf/open/floor/plating{
	baseturf = /turf/open/floor/plating/lava/smooth/lava_land_surface
	},
/area/ruin/powered)
"aV" = (
/obj/structure/closet/secure_closet/medical1,
/turf/open/floor/plasteel/white{
	baseturf = /turf/open/floor/plating/lava/smooth/lava_land_surface
	},
/area/ruin/powered)
"aW" = (
/obj/machinery/vending/wallmed{
	pixel_y = 28
	},
/turf/open/floor/plasteel/white{
	baseturf = /turf/open/floor/plating/lava/smooth/lava_land_surface
	},
/area/ruin/powered)
"aX" = (
/obj/item/stack/cable_coil/random,
/turf/open/floor/plating{
	baseturf = /turf/open/floor/plating/lava/smooth/lava_land_surface
	},
/area/ruin/powered)
"aY" = (
/obj/structure/bodycontainer/morgue,
/turf/open/floor/plating{
	baseturf = /turf/open/floor/plating/lava/smooth/lava_land_surface
	},
/area/ruin/powered)
"aZ" = (
/obj/effect/decal/cleanable/ash,
/turf/open/floor/plating{
	baseturf = /turf/open/floor/plating/lava/smooth/lava_land_surface
	},
/area/ruin/powered)
"ba" = (
/obj/structure/table/glass,
/obj/item/weapon/reagent_containers/glass/beaker,
/obj/item/weapon/storage/backpack/dufflebag/med,
/turf/open/floor/plasteel/white{
	baseturf = /turf/open/floor/plating/lava/smooth/lava_land_surface
	},
/area/ruin/powered)
"bb" = (
/obj/structure/table/reinforced,
/obj/item/device/laser_pointer,
/turf/open/floor/plasteel/white{
	baseturf = /turf/open/floor/plating/lava/smooth/lava_land_surface
	},
/area/ruin/powered)
"bc" = (
/obj/structure/table/reinforced,
/obj/item/weapon/storage/firstaid/regular,
/turf/open/floor/plasteel/white{
	baseturf = /turf/open/floor/plating/lava/smooth/lava_land_surface
	},
/area/ruin/powered)
"bd" = (
/obj/structure/table/glass,
/obj/item/weapon/storage/box/gloves,
/obj/item/weapon/storage/box/masks{
	pixel_x = 3;
	pixel_y = 3
	},
/turf/open/floor/plasteel/white{
	baseturf = /turf/open/floor/plating/lava/smooth/lava_land_surface
	},
/area/ruin/powered)
"be" = (
/obj/effect/decal/cleanable/oil,
/obj/item/weapon/storage/toolbox/mechanical,
/turf/open/floor/plating{
	baseturf = /turf/open/floor/plating/lava/smooth/lava_land_surface
	},
/area/ruin/powered)
"bf" = (
/obj/structure/table,
/obj/item/weapon/storage/fancy/cigarettes/dromedaryco,
/obj/item/weapon/storage/box/matches,
/turf/open/floor/plating{
	baseturf = /turf/open/floor/plating/lava/smooth/lava_land_surface
	},
/area/ruin/powered)
"bg" = (
/mob/living/simple_animal/cockroach,
/turf/open/floor/plating{
	baseturf = /turf/open/floor/plating/lava/smooth/lava_land_surface
	},
/area/ruin/powered)
"bh" = (
/obj/structure/table/glass,
/obj/item/weapon/storage/firstaid/brute,
/turf/open/floor/plasteel/white{
	baseturf = /turf/open/floor/plating/lava/smooth/lava_land_surface
	},
/area/ruin/powered)
"bi" = (
/obj/item/toy/cattoy,
/turf/open/floor/plasteel/white{
	baseturf = /turf/open/floor/plating/lava/smooth/lava_land_surface
	},
/area/ruin/powered)
"bj" = (
/obj/structure/table/glass,
/obj/item/weapon/lazarus_injector,
/turf/open/floor/plasteel/white{
	baseturf = /turf/open/floor/plating/lava/smooth/lava_land_surface
	},
/area/ruin/powered)
"bk" = (
/obj/structure/reagent_dispensers/fueltank,
/turf/open/floor/plating{
	baseturf = /turf/open/floor/plating/lava/smooth/lava_land_surface
	},
/area/ruin/powered)
"bl" = (
/obj/structure/table,
/obj/item/weapon/reagent_containers/food/snacks/cookie{
	name = "doggie biscuit"
	},
/obj/item/weapon/reagent_containers/food/snacks/cookie{
	name = "doggie biscuit"
	},
/obj/item/weapon/reagent_containers/food/snacks/cookie{
	name = "doggie biscuit"
	},
/obj/item/weapon/reagent_containers/food/snacks/cookie{
	name = "doggie biscuit"
	},
/obj/item/weapon/reagent_containers/food/snacks/cookie{
	name = "doggie biscuit"
	},
/obj/item/weapon/reagent_containers/food/snacks/cookie{
	name = "doggie biscuit"
	},
/turf/open/floor/plasteel/blue/side{
	baseturf = /turf/open/floor/plating/lava/smooth/lava_land_surface;
	dir = 1
	},
/area/ruin/powered)
"bm" = (
/obj/structure/chair/comfy/teal{
	dir = 8
	},
/turf/open/floor/plasteel/blue/side{
	baseturf = /turf/open/floor/plating/lava/smooth/lava_land_surface;
	dir = 1
	},
/area/ruin/powered)
"bn" = (
/obj/structure/bed/dogbed,
/turf/open/floor/plasteel/white{
	baseturf = /turf/open/floor/plating/lava/smooth/lava_land_surface
	},
/area/ruin/powered)
"bo" = (
/obj/item/weapon/reagent_containers/glass/bowl,
/obj/item/weapon/reagent_containers/food/snacks/cheesewedge,
/obj/item/weapon/reagent_containers/food/snacks/cheesewedge,
/turf/open/floor/plasteel/white{
	baseturf = /turf/open/floor/plating/lava/smooth/lava_land_surface
	},
/area/ruin/powered)
"bp" = (
/obj/structure/closet/crate/bin,
/obj/item/trash/pistachios,
/obj/item/weapon/lipstick/random,
/obj/item/seeds/apple,
/turf/open/floor/plasteel/blue/side{
	baseturf = /turf/open/floor/plating/lava/smooth/lava_land_surface;
	dir = 8
	},
/area/ruin/powered)
"bq" = (
/obj/structure/filingcabinet/chestdrawer/wheeled,
/turf/open/floor/plasteel{
	baseturf = /turf/open/floor/plating/lava/smooth/lava_land_surface
	},
/area/ruin/powered)
"br" = (
/obj/structure/chair/office/dark,
/turf/open/floor/plasteel{
	baseturf = /turf/open/floor/plating/lava/smooth/lava_land_surface
	},
/area/ruin/powered)
"bs" = (
/obj/structure/table/reinforced,
/obj/item/weapon/phone,
/turf/open/floor/plasteel{
	baseturf = /turf/open/floor/plating/lava/smooth/lava_land_surface
	},
/area/ruin/powered)
"bt" = (
/obj/structure/flora/kirbyplants,
/turf/open/floor/plasteel{
	baseturf = /turf/open/floor/plating/lava/smooth/lava_land_surface
	},
/area/ruin/powered)
"bu" = (
/obj/structure/chair/comfy/teal{
	dir = 8
	},
/turf/open/floor/plasteel/blue/side{
	baseturf = /turf/open/floor/plating/lava/smooth/lava_land_surface;
	dir = 4
	},
/area/ruin/powered)
"bv" = (
/obj/effect/mob_spawn/mouse{
	dir = 4;
	flavour_text = "<font size=3><b>Y</b></font><b>ou're a mousey! You're getting pretty old as mice go, and you haven't been feeling well as of late. Your master loves you a lot so he took you to this place so you can get better! You can't wait to see him again!<b>";
	mob_name = "Stallman Jr."
	},
/turf/open/floor/plasteel/white{
	baseturf = /turf/open/floor/plating/lava/smooth/lava_land_surface
	},
/area/ruin/powered)
"bw" = (
/obj/effect/decal/cleanable/dirt,
/turf/open/floor/plasteel/white{
	baseturf = /turf/open/floor/plating/lava/smooth/lava_land_surface
	},
/area/ruin/powered)
"bx" = (
/obj/machinery/door/airlock/medical{
	name = "Patient Room";
	req_access_txt = "0"
	},
/turf/open/floor/plasteel/white{
	baseturf = /turf/open/floor/plating/lava/smooth/lava_land_surface
	},
/area/ruin/powered)
"by" = (
/obj/structure/table/reinforced,
/obj/item/device/flashlight/lamp,
/turf/open/floor/plasteel/blue/side{
	baseturf = /turf/open/floor/plating/lava/smooth/lava_land_surface;
	dir = 8
	},
/area/ruin/powered)
"bz" = (
/obj/structure/table/reinforced,
/obj/item/clothing/glasses/regular,
/turf/open/floor/plasteel{
	baseturf = /turf/open/floor/plating/lava/smooth/lava_land_surface
	},
/area/ruin/powered)
"bA" = (
/obj/structure/table/reinforced,
/obj/item/weapon/paper_bin,
/obj/item/weapon/pen/fourcolor,
/turf/open/floor/plasteel{
	baseturf = /turf/open/floor/plating/lava/smooth/lava_land_surface
	},
/area/ruin/powered)
"bB" = (
/obj/structure/table/reinforced,
/obj/item/weapon/storage/box/hug,
/turf/open/floor/plasteel{
	baseturf = /turf/open/floor/plating/lava/smooth/lava_land_surface
	},
/area/ruin/powered)
"bC" = (
/obj/structure/chair/office/light{
	dir = 1
	},
/turf/open/floor/plasteel/white{
	baseturf = /turf/open/floor/plating/lava/smooth/lava_land_surface
	},
/area/ruin/powered)
"bD" = (
/obj/structure/table/glass,
/obj/item/weapon/reagent_containers/glass/bottle/cyanide{
	desc = "A cocktail of chemotherpy drugs intended to treat bladder cancer.";
	name = "MVAC regimen"
	},
/obj/item/weapon/reagent_containers/syringe,
/turf/open/floor/plasteel/white{
	baseturf = /turf/open/floor/plating/lava/smooth/lava_land_surface
	},
/area/ruin/powered)
"bE" = (
/obj/structure/closet/crate/critter,
/turf/open/floor/plasteel/blue/side{
	baseturf = /turf/open/floor/plating/lava/smooth/lava_land_surface;
	dir = 8
	},
/area/ruin/powered)
"bF" = (
/turf/open/floor/plasteel/blue/side{
	baseturf = /turf/open/floor/plating/lava/smooth/lava_land_surface;
	dir = 10
	},
/area/ruin/powered)
"bG" = (
/obj/structure/chair/comfy/teal{
	dir = 8
	},
/turf/open/floor/plasteel/blue/side{
	baseturf = /turf/open/floor/plating/lava/smooth/lava_land_surface;
	dir = 6
	},
/area/ruin/powered)
"bH" = (
/obj/structure/table,
/obj/item/weapon/tank/internals/oxygen,
/obj/item/weapon/tank/internals/oxygen,
/turf/open/floor/plasteel/blue/side{
	baseturf = /turf/open/floor/plating/lava/smooth/lava_land_surface;
	dir = 8
	},
/area/ruin/powered)
"bI" = (
/obj/structure/sign/bluecross_2{
	name = "animal hospital"
	},
/turf/closed/wall/shuttle/smooth{
	baseturf = /turf/open/floor/plating/lava/smooth/lava_land_surface
	},
/area/ruin/powered)
"bJ" = (
/obj/machinery/door/airlock/glass_large{
	name = "Ian's Pet Care"
	},
/turf/open/floor/plasteel{
	baseturf = /turf/open/floor/plating/lava/smooth/lava_land_surface
	},
/area/ruin/powered)
"bK" = (
/obj/item/weapon/reagent_containers/glass/bowl,
/obj/item/weapon/reagent_containers/food/snacks/grown/wheat,
/obj/item/weapon/reagent_containers/food/snacks/grown/wheat,
/obj/item/weapon/reagent_containers/food/snacks/grown/wheat,
/obj/effect/decal/cleanable/dirt,
/turf/open/floor/plasteel/white{
	baseturf = /turf/open/floor/plating/lava/smooth/lava_land_surface
	},
/area/ruin/powered)
"bN" = (
/obj/effect/mob_spawn/cow{
	dir = 4;
	flavour_text = "<font size=3><b>Y</b></font><b>ou're a cow. You've lived a pampered life as a prized show heifer, a real blue-ribbon winner. After showing signs of a minor respiratory infection, your master took you to the hospital right away. He'd better come back soon. You're getting quite impatient.</b>";
	mob_name = "Flossie"
	},
/turf/open/floor/plasteel/white{
	baseturf = /turf/open/floor/plating/lava/smooth/lava_land_surface
	},
/area/ruin/powered)
"bP" = (
/obj/structure/chair/office/light{
	dir = 4
	},
/obj/effect/decal/cleanable/dirt,
/turf/open/floor/plasteel/white{
	baseturf = /turf/open/floor/plating/lava/smooth/lava_land_surface
	},
/area/ruin/powered)
"bQ" = (
/obj/structure/table/glass,
/obj/item/clothing/tie/petcollar,
/obj/item/weapon/pen/blue,
/turf/open/floor/plasteel/white{
	baseturf = /turf/open/floor/plating/lava/smooth/lava_land_surface
	},
/area/ruin/powered)
"bR" = (
/obj/structure/table,
/obj/machinery/cell_charger,
/obj/item/weapon/melee/baton/cattleprod{
	desc = "On-the-fly rabies treatment.";
	name = "cattle prod"
	},
/obj/item/weapon/stock_parts/cell/high,
/turf/open/floor/plasteel/blue/side{
	baseturf = /turf/open/floor/plating/lava/smooth/lava_land_surface;
	dir = 10
	},
/area/ruin/powered)
"bS" = (
/obj/structure/closet,
/obj/item/weapon/defibrillator/loaded,
/obj/item/weapon/storage/belt/medical,
/obj/item/clothing/glasses/hud/health,
/turf/open/floor/plasteel/blue/side{
	baseturf = /turf/open/floor/plating/lava/smooth/lava_land_surface;
	dir = 6
	},
/area/ruin/powered)
"cc" = (
/obj/machinery/atmospherics/pipe/simple/general/visible,
/turf/closed/wall/shuttle/smooth{
	baseturf = /turf/open/floor/plating/lava/smooth/lava_land_surface
	},
/area/ruin/powered)
"cd" = (
/obj/structure/table/reinforced,
/obj/item/clothing/gloves/color/latex,
/obj/item/clothing/mask/surgical,
/obj/item/clothing/suit/apron/surgical,
/turf/open/floor/plasteel/white{
	baseturf = /turf/open/floor/plating/lava/smooth/lava_land_surface
	},
/area/ruin/powered)
"ce" = (
/obj/machinery/atmospherics/components/unary/portables_connector/visible{
	dir = 1
	},
/obj/machinery/portable_atmospherics/pump,
/turf/open/floor/plasteel/white{
	baseturf = /turf/open/floor/plating/lava/smooth/lava_land_surface
	},
/area/ruin/powered)
"cf" = (
/obj/structure/closet/l3closet,
/turf/open/floor/plasteel/white{
	baseturf = /turf/open/floor/plating/lava/smooth/lava_land_surface
	},
/area/ruin/powered)
"cg" = (
/obj/machinery/door/unpowered/shuttle{
	name = "Break Room"
	},
/turf/open/floor/plasteel/cmo{
	baseturf = /turf/open/floor/plating/lava/smooth/lava_land_surface
	},
/area/ruin/powered)
"ch" = (
/obj/machinery/door/unpowered/shuttle{
	name = "Emergency Care"
	},
/turf/open/floor/plasteel/white{
	baseturf = /turf/open/floor/plating/lava/smooth/lava_land_surface
	},
/area/ruin/powered)
"ci" = (
/obj/machinery/door/unpowered/shuttle{
	desc = "There's a note wedged in the seam saying something about directing pizza here.";
	name = "Staff Entrance"
	},
/turf/open/floor/plating{
	baseturf = /turf/open/floor/plating/lava/smooth/lava_land_surface
	},
/area/ruin/powered)
"cj" = (
/obj/machinery/door/unpowered/shuttle{
	name = "Morgue"
	},
/turf/open/floor/plating{
	baseturf = /turf/open/floor/plating/lava/smooth/lava_land_surface
	},
/area/ruin/powered)
"ck" = (
/obj/machinery/door/unpowered/shuttle{
	name = "Medical Supplies"
	},
/turf/open/floor/plasteel/white{
	baseturf = /turf/open/floor/plating/lava/smooth/lava_land_surface
	},
/area/ruin/powered)
"cl" = (
/obj/machinery/door/unpowered/shuttle{
	name = "Safety Supplies"
	},
/turf/open/floor/plasteel/white{
	baseturf = /turf/open/floor/plating/lava/smooth/lava_land_surface
	},
/area/ruin/powered)
"cm" = (
/obj/machinery/door/unpowered/shuttle{
	name = "Tool Storage"
	},
/turf/open/floor/plating{
	baseturf = /turf/open/floor/plating/lava/smooth/lava_land_surface
	},
/area/ruin/powered)
"gG" = (
/obj/vehicle/scooter/skateboard{
	dir = 4
	},
/turf/open/floor/grass{
	baseturf = /turf/open/floor/plating/lava/smooth/lava_land_surface
	},
/area/lavaland/surface/outdoors/mapgen_protected)
"pi" = (
/obj/machinery/atmospherics/pipe/simple/general/visible{
	dir = 10
	},
/turf/open/floor/grass{
	baseturf = /turf/open/floor/plating/lava/smooth/lava_land_surface
	},
/area/lavaland/surface/outdoors/mapgen_protected)
"uX" = (
/obj/structure/closet/crate/trashcart,
/obj/item/weapon/storage/bag/trash,
/obj/item/trash/cheesie,
/obj/item/weapon/reagent_containers/syringe/antiviral,
/obj/item/bodybag,
/obj/item/weapon/reagent_containers/food/drinks/bottle/vodka,
/turf/open/floor/grass{
	baseturf = /turf/open/floor/plating/lava/smooth/lava_land_surface
	},
/area/lavaland/surface/outdoors/mapgen_protected)
"vC" = (
/turf/open/floor/plating/asteroid/basalt/lava_land_surface,
/area/lavaland/surface/outdoors/mapgen_protected)
"wS" = (
/obj/structure/flora/ausbushes/sunnybush,
/turf/open/floor/grass{
	baseturf = /turf/open/floor/plating/lava/smooth/lava_land_surface
	},
/area/lavaland/surface/outdoors/mapgen_protected)
"xL" = (
/obj/structure/flora/ausbushes/brflowers,
/turf/open/floor/grass{
	baseturf = /turf/open/floor/plating/lava/smooth/lava_land_surface
	},
/area/lavaland/surface/outdoors/mapgen_protected)
"zi" = (
/obj/machinery/atmospherics/pipe/manifold/general/visible{
	dir = 1
	},
/turf/open/floor/grass{
	baseturf = /turf/open/floor/plating/lava/smooth/lava_land_surface
	},
/area/lavaland/surface/outdoors/mapgen_protected)
"Aw" = (
/obj/item/weapon/pickaxe,
/obj/effect/decal/cleanable/blood/old,
/turf/open/floor/plating/asteroid/basalt/lava_land_surface,
/area/lavaland/surface/outdoors/mapgen_protected)
"Co" = (
/obj/machinery/atmospherics/pipe/simple/general/visible{
	dir = 6
	},
/turf/open/floor/grass{
	baseturf = /turf/open/floor/plating/lava/smooth/lava_land_surface
	},
/area/lavaland/surface/outdoors/mapgen_protected)
"Cv" = (
/obj/machinery/atmospherics/components/binary/valve,
/turf/open/floor/grass{
	baseturf = /turf/open/floor/plating/lava/smooth/lava_land_surface
	},
/area/lavaland/surface/outdoors/mapgen_protected)
"Fd" = (
/turf/open/floor/grass,
/area/lavaland/surface/outdoors/mapgen_protected)
"Hr" = (
/obj/machinery/atmospherics/components/unary/tank/air{
	dir = 4
	},
/turf/open/floor/grass{
	baseturf = /turf/open/floor/plating/lava/smooth/lava_land_surface
	},
/area/lavaland/surface/outdoors/mapgen_protected)
"Hv" = (
/obj/effect/decal/remains/human,
/turf/open/floor/plating/asteroid/basalt/lava_land_surface,
/area/lavaland/surface/outdoors/mapgen_protected)
"HT" = (
/obj/effect/decal/cleanable/blood/old,
/turf/open/floor/plating/asteroid/basalt/lava_land_surface,
/area/lavaland/surface/outdoors/mapgen_protected)
"Po" = (
/obj/structure/flora/ausbushes/ppflowers,
/turf/open/floor/grass{
	baseturf = /turf/open/floor/plating/lava/smooth/lava_land_surface
	},
/area/lavaland/surface/outdoors/mapgen_protected)
"PI" = (
/turf/open/floor/grass{
	baseturf = /turf/open/floor/plating/lava/smooth/lava_land_surface
	},
/area/lavaland/surface/outdoors/mapgen_protected)
"UD" = (
/turf/open/floor/plasteel/grimy{
	baseturf = /turf/open/floor/plating/lava/smooth/lava_land_surface
	},
/area/lavaland/surface/outdoors/mapgen_protected)

(1,1,1) = {"
aa
aa
aa
aa
aa
aa
aa
aa
vC
vC
vC
aa
vC
aa
aa
aa
aa
aa
aa
aa
aa
aa
aa
aa
aa
aa
aa
aa
"}
(2,1,1) = {"
aa
aa
aa
aa
aa
aa
aa
vC
vC
vC
vC
vC
vC
vC
aa
aa
aa
aa
aa
aa
aa
aa
aa
vC
vC
vC
aa
aa
"}
(3,1,1) = {"
aa
aa
aa
aa
aa
vC
vC
vC
vC
UD
vC
vC
PI
vC
aa
aa
aa
aa
aa
aa
aa
vC
vC
vC
Hv
HT
vC
vC
"}
(4,1,1) = {"
aa
aa
aa
aa
aa
vC
vC
uX
PI
UD
PI
ae
ae
ae
ae
ae
aa
aa
aa
aa
vC
vC
vC
Aw
vC
vC
vC
vC
"}
(5,1,1) = {"
aa
aa
aa
aa
ae
ae
ae
ae
aE
ci
ae
aE
aT
aY
bf
aE
ae
ae
ae
ae
ae
PI
vC
vC
vC
vC
vC
vC
"}
(6,1,1) = {"
aa
aa
aa
vC
ae
ag
ag
ay
ae
aK
aK
cj
aU
aZ
bg
cj
aK
bp
by
bF
ae
PI
PI
vC
vC
vC
vC
vC
"}
(7,1,1) = {"
aa
vC
vC
vC
ae
ah
ag
ag
aF
aK
aK
aE
ae
ae
ae
aE
aL
bq
bz
aP
af
xL
PI
PI
vC
vC
Fd
Fd
"}
(8,1,1) = {"
aa
vC
vC
PI
ae
ae
ae
ae
aG
aL
aP
ae
aV
ba
bh
aG
aL
br
bA
aP
af
gG
PI
PI
PI
vC
vC
vC
"}
(9,1,1) = {"
vC
vC
PI
PI
ae
ai
as
as
cg
aK
aP
ae
aW
ao
bi
ae
aL
bs
bB
aP
bI
wS
PI
vC
vC
vC
vC
vC
"}
(10,1,1) = {"
vC
vC
vC
PI
af
aj
at
as
ae
aM
aK
ck
ao
bb
ao
ck
aK
aK
aK
aK
bJ
UD
UD
UD
vC
vC
vC
vC
"}
(11,1,1) = {"
vC
PI
PI
PI
af
ak
as
az
ae
aM
aP
ae
ae
ae
ae
ae
bl
bt
aK
aK
aK
UD
UD
vC
vC
Fd
vC
vC
"}
(12,1,1) = {"
vC
PI
PI
xL
af
al
au
as
ae
aM
aK
cl
ao
bc
ao
cl
aK
aK
aK
aP
ae
wS
PI
PI
vC
vC
vC
vC
"}
(13,1,1) = {"
vC
vC
PI
PI
ae
am
as
as
cg
aK
aP
ae
aW
ao
ao
ae
bm
bu
bu
bG
ae
PI
Po
PI
vC
vC
vC
vC
"}
(14,1,1) = {"
vC
PI
Co
Hr
ae
ae
ae
ae
aH
aL
aP
ae
cf
bd
bj
ae
ae
ae
ae
ae
ae
ae
ae
ae
vC
vC
aa
aa
"}
(15,1,1) = {"
vC
vC
zi
Hr
ae
cd
an
aA
ae
aL
aP
aE
ae
ae
ae
ae
bn
bv
bC
ae
bn
bN
bP
ae
vC
vC
aa
aa
"}
(16,1,1) = {"
aa
vC
pi
Cv
cc
ce
ao
ao
ch
aK
aK
cm
aX
be
bk
ae
bo
bw
bD
ae
bK
ao
bQ
ae
vC
aa
aa
aa
"}
(17,1,1) = {"
aa
vC
vC
PI
ae
ap
ao
aB
aI
aL
aP
ae
ae
ae
ae
aE
af
bx
ae
aE
af
bx
ae
ae
aa
aa
aa
aa
"}
(18,1,1) = {"
aa
aa
vC
PI
ae
aq
ao
aC
aI
aN
aQ
aS
aS
aS
aS
aS
av
aK
bE
bH
aS
aK
bR
ae
aa
aa
aa
aa
"}
(19,1,1) = {"
aa
aa
vC
vC
ae
ar
aw
aD
aI
aO
aR
aR
aR
aR
aR
aR
aR
aR
aR
aR
aR
aR
bS
ae
aa
aa
aa
aa
"}
(20,1,1) = {"
aa
aa
aa
vC
ae
ae
ae
ae
ae
ae
ae
ae
ae
ae
ae
ae
ae
ae
ae
ae
ae
ae
ae
ae
aa
aa
aa
aa
"}
(21,1,1) = {"
aa
aa
aa
aa
aa
aa
aa
aa
aa
aa
aa
aa
aa
aa
aa
aa
aa
aa
aa
aa
aa
aa
aa
aa
aa
aa
aa
aa
"}
