//MAP CONVERTED BY dmm2tgm.py THIS HEADER COMMENT PREVENTS RECONVERSION, DO NOT REMOVE 
"a" = (
/turf/template_noop,
/area/template_noop)
"b" = (
/turf/closed/wall/shuttle/smooth/nodiagonal,
/area/ruin/powered)
"c" = (
/turf/closed/wall/shuttle,
/area/ruin/powered)
"d" = (
/turf/closed/wall/shuttle/interior,
/area/ruin/powered)
"e" = (
/obj/machinery/door/airlock/external,
/obj/structure/fans/tiny/invisible,
/turf/open/floor/plasteel/shuttle/red,
/area/ruin/powered)
"f" = (
/turf/open/floor/plasteel/shuttle/red,
/area/ruin/powered)
"g" = (
/obj/effect/decal/cleanable/blood,
/obj/effect/mob_spawn/human/corpse/syndicatesoldier,
/turf/open/floor/plasteel/shuttle/red,
/area/ruin/powered)
"h" = (
/obj/item/ammo_casing/a762,
/turf/open/floor/plasteel/shuttle/red,
/area/ruin/powered)
"i" = (
/obj/effect/decal/cleanable/xenoblood,
/obj/machinery/light{
	dir = 1
	},
/obj/item/weapon/tank/internals/oxygen,
/turf/open/floor/plasteel/shuttle/red,
/area/ruin/powered)
"j" = (
/turf/closed/wall/shuttle/smooth,
/area/ruin/powered)
"k" = (
/obj/machinery/door/airlock/hatch,
/obj/structure/fans/tiny/invisible,
/turf/open/floor/plasteel/shuttle/red,
/area/ruin/powered)
"l" = (
/obj/structure/chair,
/mob/living/simple_animal/hostile/alien/sentinel,
/turf/open/floor/plasteel/shuttle/red,
/area/ruin/powered)
"m" = (
/obj/structure/chair,
/turf/open/floor/plasteel/shuttle/red,
/area/ruin/powered)
"n" = (
/obj/effect/decal/cleanable/blood,
/obj/item/chair,
/obj/effect/mob_spawn/human/corpse/syndicatesoldier,
/turf/open/floor/plasteel/shuttle/red,
/area/ruin/powered)
"o" = (
/obj/item/trash/syndi_cakes,
/turf/open/floor/plasteel/shuttle/red,
/area/ruin/powered)
"p" = (
/obj/effect/decal/cleanable/blood,
/turf/open/floor/plasteel/shuttle/red,
/area/ruin/powered)
"q" = (
/obj/effect/decal/cleanable/xenoblood,
/turf/open/floor/plasteel/shuttle/red,
/area/ruin/powered)
"r" = (
/obj/machinery/light{
	dir = 4;
	icon_state = "tube1"
	},
/turf/open/floor/plasteel/shuttle/red,
/area/ruin/powered)
"s" = (
/obj/machinery/light{
	icon_state = "tube1";
	dir = 8
	},
/turf/open/floor/plasteel/shuttle/red,
/area/ruin/powered)
"t" = (
/obj/item/chair,
/turf/open/floor/plasteel/shuttle/red,
/area/ruin/powered)
"u" = (
/obj/structure/closet/crate,
/obj/item/clothing/glasses/meson/night,
/obj/item/toy/nuke,
/obj/item/toy/figure/syndie,
/turf/open/floor/plasteel/shuttle/red,
/area/ruin/powered)
"v" = (
/obj/structure/table,
/obj/item/weapon/gun/projectile/automatic/pistol,
/turf/open/floor/plasteel/shuttle/red,
/area/ruin/powered)
"w" = (
/obj/structure/shuttle/engine/platform,
/turf/closed/wall/shuttle/smooth,
/area/ruin/powered)
"x" = (
/obj/structure/shuttle/engine/propulsion,
/turf/template_noop,
/area/template_noop)

(1,1,1) = {"
a
a
a
a
a
a
a
a
a
a
"}
(2,1,1) = {"
b
d
d
d
d
d
j
b
a
a
"}
(3,1,1) = {"
c
f
j
l
o
s
g
w
x
a
"}
(4,1,1) = {"
d
g
j
m
p
f
t
j
a
a
"}
(5,1,1) = {"
e
h
k
f
q
f
u
j
a
a
"}
(6,1,1) = {"
d
i
j
m
f
p
q
j
a
a
"}
(7,1,1) = {"
c
f
j
n
r
f
v
w
x
a
"}
(8,1,1) = {"
b
d
d
j
j
j
j
b
a
a
"}
(9,1,1) = {"
a
a
a
a
a
a
a
a
a
a
"}
(10,1,1) = {"
a
a
a
a
a
a
a
a
a
a
"}
