"aa" = (/turf/template_noop,/area/space)
"ab" = (/turf/closed/mineral/volcanic/lava_land_surface,/area/space)
"ac" = (/turf/closed/wall/r_wall,/area/space)
"ad" = (/obj/structure/rack,/obj/item/weapon/gun/energy/gun,/turf/open/floor/plasteel/black,/area/space)
"ae" = (/obj/structure/table/reinforced,/obj/item/weapon/melee/baton/loaded{pixel_x = 2},/obj/item/weapon/melee/baton/loaded{pixel_x = -2},/turf/open/floor/plasteel/black,/area/space)
"af" = (/obj/structure/table/reinforced,/obj/machinery/recharger,/turf/open/floor/plasteel/black,/area/space)
"ag" = (/obj/structure/table/reinforced,/obj/item/ammo_box/magazine/smgm45,/obj/item/ammo_box/magazine/smgm45,/turf/open/floor/plasteel/black,/area/space)
"ah" = (/obj/structure/rack,/obj/item/weapon/gun/projectile/automatic/c20r/sc_c20r,/turf/open/floor/plasteel/black,/area/space)
"ai" = (/obj/structure/rack,/obj/item/clothing/suit/armor/laserproof,/obj/item/clothing/suit/armor/laserproof,/turf/open/floor/plasteel/black,/area/space)
"aj" = (/turf/open/floor/plasteel/darkred/side{dir = 9},/area/space)
"ak" = (/turf/open/floor/plasteel/darkred/side{tag = "icon-darkred (NORTH)"; icon_state = "darkred"; dir = 1},/area/space)
"al" = (/turf/open/floor/plasteel/darkred/side{tag = "icon-darkred (NORTHEAST)"; icon_state = "darkred"; dir = 5},/area/space)
"am" = (/obj/structure/rack,/obj/item/clothing/suit/armor/bulletproof,/turf/open/floor/plasteel/black,/area/space)
"an" = (/obj/machinery/deployable/barrier,/turf/open/floor/plasteel/black,/area/space)
"ao" = (/turf/open/floor/plasteel/darkred/side{tag = "icon-darkred (WEST)"; icon_state = "darkred"; dir = 8},/area/space)
"ap" = (/turf/open/floor/plasteel/black,/area/space)
"aq" = (/turf/open/floor/plasteel/darkred/side{tag = "icon-darkred (EAST)"; icon_state = "darkred"; dir = 4},/area/space)
"ar" = (/obj/structure/rack,/turf/open/floor/plasteel/black,/area/space)
"as" = (/turf/open/floor/plating/asteroid/basalt/lava_land_surface,/area/space)
"at" = (/turf/open/floor/plating/lava/smooth/lava_land_surface,/area/space)
"au" = (/obj/structure/rack,/obj/item/weapon/storage/box/barriers,/turf/open/floor/plasteel/black,/area/space)
"av" = (/obj/structure/girder/reinforced,/turf/open/floor/plating{icon_state = "panelscorched"},/area/space)
"aw" = (/turf/open/floor/plating{icon_state = "panelscorched"},/area/space)
"ax" = (/obj/structure/rack,/obj/item/weapon/storage/box/handcuffs,/turf/open/floor/plasteel/black,/area/space)
"ay" = (/obj/structure/rack,/obj/item/device/assembly/flash/handheld{pixel_x = -3; pixel_y = -1},/obj/item/device/assembly/flash/handheld{pixel_x = 3},/turf/open/floor/plasteel/black,/area/space)
"az" = (/obj/machinery/door/airlock/highsecurity,/turf/open/space,/area/space)
"aA" = (/obj/structure/girder/reinforced,/obj/effect/decal/cleanable/dirt,/turf/open/floor/plating{icon_state = "panelscorched"},/area/space)
"aB" = (/obj/effect/decal/cleanable/dirt,/turf/open/floor/engine,/area/space)
"aC" = (/turf/open/floor/engine,/area/space)
"aD" = (/turf/open/floor/plasteel/darkred/corner{tag = "icon-darkredcorners (NORTH)"; icon_state = "darkredcorners"; dir = 1},/area/space)
"aE" = (/obj/effect/decal/cleanable/dirt,/turf/open/floor/plating{icon_state = "panelscorched"},/area/space)
"aF" = (/obj/effect/decal/cleanable/blood,/obj/effect/decal/cleanable/blood/tracks{tag = "icon-tracks (WEST)"; icon_state = "tracks"; dir = 8},/mob/living/simple_animal/hostile/faithless,/turf/open/floor/engine,/area/space)
"aG" = (/obj/effect/decal/cleanable/blood/tracks{tag = "icon-tracks (WEST)"; icon_state = "tracks"; dir = 8},/turf/open/floor/engine,/area/space)
"aH" = (/obj/effect/decal/cleanable/blood/tracks{tag = "icon-tracks (WEST)"; icon_state = "tracks"; dir = 8},/turf/open/floor/plating{icon_state = "panelscorched"},/area/space)
"aI" = (/obj/effect/decal/cleanable/blood/tracks{tag = "icon-tracks (NORTHEAST)"; icon_state = "tracks"; dir = 5},/turf/open/floor/plasteel/darkred/corner{tag = "icon-darkredcorners (NORTH)"; icon_state = "darkredcorners"; dir = 1},/area/space)
"aJ" = (/obj/effect/decal/cleanable/dirt,/turf/open/floor/plating/asteroid/basalt/lava_land_surface,/area/space)
"aK" = (/obj/effect/decal/cleanable/blood/tracks,/turf/open/floor/plasteel/darkred/corner{tag = "icon-darkredcorners (NORTH)"; icon_state = "darkredcorners"; dir = 1},/area/space)
"aL" = (/obj/effect/decal/cleanable/dirt,/obj/item/stack/tile/plasteel,/turf/open/floor/plating{icon_state = "panelscorched"},/area/space)
"aM" = (/obj/effect/decal/cleanable/blood/tracks{tag = "icon-tracks (SOUTHWEST)"; icon_state = "tracks"; dir = 10},/turf/open/floor/plasteel/darkred/corner{tag = "icon-darkredcorners (NORTH)"; icon_state = "darkredcorners"; dir = 1},/area/space)
"aN" = (/obj/effect/mob_spawn/human/corpse/nanotrasensoldier,/obj/effect/decal/cleanable/blood,/turf/open/floor/plasteel/black,/area/space)
"aO" = (/obj/effect/decal/cleanable/dirt,/obj/item/stack/rods{amount = 50},/turf/open/floor/plating{icon_state = "panelscorched"},/area/space)
"aP" = (/obj/effect/decal/cleanable/dirt,/obj/item/stack/rods,/turf/open/floor/plating{icon_state = "panelscorched"},/area/space)
"aQ" = (/turf/open/floor/plating,/area/space)
"aR" = (/obj/machinery/door/airlock/maintenance,/turf/open/floor/plating,/area/space)
"aS" = (/obj/structure/rack,/obj/effect/spawner/lootdrop/maintenance,/turf/open/floor/plating,/area/space)
"aT" = (/obj/structure/girder/displaced,/turf/open/floor/plating{icon_state = "panelscorched"},/area/space)
"aU" = (/obj/effect/decal/cleanable/cobweb{tag = "icon-cobweb2"; icon_state = "cobweb2"},/turf/open/floor/engine,/area/space)
"aV" = (/obj/structure/sign/kiddieplaque{desc = "WARNING. ACCESS IS LIMITED TO NANOTRASEN LEVEL 5-B PERSONNEL. IF YOU ARE NOT AUTHORIZED PERSONNEL AND ARE READING THIS, PLEASE INFORM YOUR LOCAL STATION COMMANDER OF A LEVEL XK-BREACH OF SITE- *the rest of the plaque is destroyed*"; name = "A dusty plaque"},/turf/closed/wall/r_wall,/area/space)
"aW" = (/obj/structure/girder/displaced,/obj/effect/decal/cleanable/dirt,/turf/open/floor/plating{icon_state = "panelscorched"},/area/space)
"aX" = (/turf/open/floor/plasteel/cult,/area/space)
"aY" = (/obj/effect/decal/cleanable/cobweb,/obj/structure/table,/turf/open/floor/plating,/area/space)
"aZ" = (/obj/structure/table,/obj/item/device/radio,/turf/open/floor/plating,/area/space)
"ba" = (/obj/structure/table,/turf/open/floor/plating,/area/space)
"bb" = (/obj/structure/frame/computer,/turf/open/floor/plating{dir = 4; icon_state = "warnplate"; luminosity = 2; initial_gas_mix = "o2=0.01;n2=0.01"; temperature = 2.7},/area/space)
"bc" = (/obj/structure/sign/pods,/turf/closed/wall/r_wall,/area/space)
"bd" = (/obj/effect/decal/cleanable/dirt{desc = "A thin layer of dust coating the floor."; name = "dust"},/turf/open/floor/plating{icon_state = "panelscorched"},/area/space)
"be" = (/obj/item/stack/rods,/obj/effect/decal/cleanable/dirt,/turf/open/floor/plating{icon_state = "panelscorched"},/area/space)
"bf" = (/obj/effect/decal/cleanable/dirt,/turf/closed/mineral/volcanic/lava_land_surface,/area/space)
"bg" = (/mob/living/simple_animal/hostile/carp/eyeball{health = 75; maxHealth = 75; melee_damage_lower = 25; melee_damage_upper = 30},/turf/open/floor/engine,/area/space)
"bh" = (/obj/effect/decal/cleanable/dirt,/turf/open/floor/plasteel/darkred/corner{tag = "icon-darkredcorners (NORTH)"; icon_state = "darkredcorners"; dir = 1},/area/space)
"bi" = (/obj/structure/girder/reinforced,/obj/effect/decal/cleanable/dirt,/obj/effect/decal/cleanable/dirt,/turf/open/floor/plating{icon_state = "panelscorched"},/area/space)
"bj" = (/turf/open/floor/plating{dir = 4; icon_state = "warnplate"; luminosity = 2; initial_gas_mix = "o2=0.01;n2=0.01"; temperature = 2.7},/area/space)
"bk" = (/obj/machinery/door/poddoor/shutters,/turf/open/floor/plating,/area/space)
"bl" = (/obj/effect/decal/cleanable/dirt,/turf/open/floor/plasteel,/area/space)
"bm" = (/obj/effect/decal/cleanable/blood,/turf/open/floor/engine,/area/space)
"bn" = (/obj/effect/decal/cleanable/dirt,/turf/open/floor/plasteel/black,/area/space)
"bo" = (/obj/machinery/door/airlock/highsecurity,/turf/closed/wall/r_wall,/area/space)
"bp" = (/obj/item/clothing/suit/cultrobes,/obj/item/clothing/head/culthood,/obj/structure/table/reinforced,/turf/open/floor/plasteel/cult,/area/space)
"bq" = (/obj/structure/girder/reinforced,/turf/open/floor/plating,/area/space)
"br" = (/obj/item/stack/cable_coil/yellow,/turf/open/floor/plating,/area/space)
"bs" = (/turf/open/floor/plasteel,/area/space)
"bt" = (/obj/effect/decal/cleanable/blood,/obj/effect/decal/cleanable/blood/gibs/body,/obj/effect/decal/cleanable/blood/tracks{tag = "icon-tracks (EAST)"; icon_state = "tracks"; dir = 4},/obj/effect/mob_spawn/human/corpse/nanotrasensoldier,/turf/open/floor/plating/asteroid/basalt/lava_land_surface,/area/space)
"bu" = (/obj/effect/decal/cleanable/blood/tracks{tag = "icon-tracks (WEST)"; icon_state = "tracks"; dir = 8},/turf/open/floor/plating/asteroid/basalt/lava_land_surface,/area/space)
"bv" = (/obj/effect/decal/cleanable/blood/tracks{tag = "icon-tracks (EAST)"; icon_state = "tracks"; dir = 4},/turf/open/floor/plating/asteroid/basalt/lava_land_surface,/area/space)
"bw" = (/obj/effect/decal/cleanable/blood/tracks{tag = "icon-tracks (EAST)"; icon_state = "tracks"; dir = 4},/turf/open/floor/plating{icon_state = "panelscorched"},/area/space)
"bx" = (/obj/effect/decal/cleanable/blood/tracks{tag = "icon-tracks (WEST)"; icon_state = "tracks"; dir = 8},/turf/open/floor/plating,/area/space)
"by" = (/obj/effect/decal/cleanable/blood/tracks{tag = "icon-tracks (EAST)"; icon_state = "tracks"; dir = 4},/turf/open/floor/plating,/area/space)
"bz" = (/obj/effect/decal/cleanable/blood/tracks{tag = "icon-tracks (EAST)"; icon_state = "tracks"; dir = 4},/turf/open/floor/plating{dir = 4; icon_state = "warnplate"; luminosity = 2; initial_gas_mix = "o2=0.01;n2=0.01"; temperature = 2.7},/area/space)
"bA" = (/obj/item/stack/rods,/obj/effect/decal/cleanable/blood/tracks{tag = "icon-tracks (EAST)"; icon_state = "tracks"; dir = 4},/turf/open/floor/plating{icon_state = "platingdmg3"},/area/space)
"bB" = (/obj/effect/decal/cleanable/blood/tracks{tag = "icon-tracks (EAST)"; icon_state = "tracks"; dir = 4},/turf/open/floor/plasteel,/area/space)
"bC" = (/obj/effect/decal/cleanable/blood/tracks{tag = "icon-tracks (NORTHEAST)"; icon_state = "tracks"; dir = 5},/turf/open/floor/plasteel,/area/space)
"bD" = (/obj/structure/sign/securearea,/turf/closed/wall/r_wall,/area/space)
"bE" = (/obj/effect/decal/cleanable/blood/tracks{tag = "icon-tracks (NORTH)"; icon_state = "tracks"; dir = 1},/turf/open/floor/plasteel,/area/space)
"bF" = (/obj/structure/girder/reinforced,/obj/effect/decal/cleanable/dirt{desc = "A thin layer of dust coating the floor."; name = "dust"},/turf/closed/wall/r_wall,/area/space)
"bG" = (/obj/machinery/recharge_station,/turf/open/floor/plasteel/black,/area/space)
"bH" = (/obj/structure/table/reinforced,/obj/item/weapon/circuitboard/machine/cyborgrecharger,/obj/item/weapon/crowbar,/obj/item/weapon/weldingtool,/turf/open/floor/plasteel/black,/area/space)
"bI" = (/turf/open/floor/plasteel/darkred/corner{tag = "icon-darkredcorners (EAST)"; icon_state = "darkredcorners"; dir = 4},/area/space)
"bJ" = (/obj/structure/sign/directions/medical{dir = 4; icon_state = "direction_med"; pixel_x = -32; pixel_y = -24; tag = "icon-direction_med (EAST)"},/turf/open/floor/engine,/area/space)
"bK" = (/obj/machinery/atmospherics/components/unary/tank/air,/turf/open/floor/plating,/area/space)
"bL" = (/obj/structure/reagent_dispensers/watertank,/turf/open/floor/plating,/area/space)
"bM" = (/obj/structure/reagent_dispensers/fueltank,/turf/open/floor/plating,/area/space)
"bN" = (/obj/effect/decal/cleanable/robot_debris/gib,/turf/open/floor/plasteel/black,/area/space)
"bO" = (/obj/structure/sign/directions/evac{tag = "icon-direction_evac (NORTH)"; icon_state = "direction_evac"; dir = 1},/turf/closed/wall/r_wall,/area/space)
"bP" = (/obj/effect/decal/cleanable/blood,/turf/open/floor/plasteel,/area/space)
"bQ" = (/turf/open/floor/plasteel/yellow/corner,/area/space)
"bR" = (/obj/item/trash/deadmouse,/turf/open/floor/plating,/area/space)
"bS" = (/obj/machinery/doppler_array{desc = "A rusty old machine."; name = "Seismic Warning System"},/turf/open/floor/plating,/area/space)
"bT" = (/obj/item/weapon/screwdriver,/turf/open/floor/plasteel/black,/area/space)
"bU" = (/obj/effect/decal/cleanable/cobweb,/turf/open/floor/plasteel/black,/area/space)
"bV" = (/obj/structure/sign/directions/security{dir = 1; icon_state = "direction_sec"; pixel_x = 32; pixel_y = 40; tag = "icon-direction_sec (NORTH)"},/turf/open/floor/plasteel/black,/area/space)
"bW" = (/obj/structure/girder/reinforced,/obj/effect/decal/cleanable/dirt,/obj/effect/decal/cleanable/blood,/turf/open/floor/plating{icon_state = "panelscorched"},/area/space)
"bX" = (/obj/item/ammo_casing/c9mm,/turf/open/floor/plasteel,/area/space)
"bY" = (/obj/effect/decal/cleanable/blood/tracks,/turf/open/floor/plating,/area/space)
"bZ" = (/obj/structure/frame/computer,/obj/item/weapon/paper{info = "THIS IS AN AUTOMATIC REPORT GENERATED BY THE SEISMIC WARNING SYSTEM (c). \[br] \[br] SLIGHT QUAKES HAVE BEEN DETECTED TO THE SOUTHEAST. OUR CURRENT ALGORITHM SUGGESTS THE SEISMIC INSTABILITY WILL SPREAD TO YOUR CURRENT LOCATION. \[br] \[br] WE PREDICT A 67.2% CHANCE OF A SIGNIFICANT EARTHQUAKE AT YOUR PRESENT LOCATION IN SIX TO TWELVE HOURS. PLEASE PROCEED WITH EARTHQUAKE THREAT PROTOCOL AS STATED IN PAGE 515 SECTION 61-X OF YOUR AOC SITE MANUAL."; name = "SEISMIC WARNING"},/turf/open/floor/plating,/area/space)
"ca" = (/obj/effect/decal/cleanable/blood,/mob/living/simple_animal/hostile/asteroid/goliath,/turf/open/floor/plasteel/black,/area/space)
"cb" = (/obj/effect/decal/cleanable/blood,/turf/open/floor/plasteel/black,/area/space)
"cc" = (/obj/effect/decal/cleanable/dirt,/obj/effect/decal/cleanable/blood,/obj/effect/decal/cleanable/blood/gibs/body,/turf/open/floor/plating{icon_state = "panelscorched"},/area/space)
"cd" = (/obj/effect/decal/cleanable/blood/tracks,/obj/effect/decal/cleanable/blood,/turf/open/floor/plasteel,/area/space)
"ce" = (/obj/item/ammo_casing/c9mm,/turf/open/floor/plating,/area/space)
"cf" = (/obj/effect/decal/cleanable/blood/gibs/body,/turf/open/floor/plasteel/black,/area/space)
"cg" = (/turf/open/floor/plasteel/darkblue/corner,/area/space)
"ch" = (/obj/effect/decal/cleanable/dirt,/turf/open/floor/plasteel/darkblue/corner,/area/space)
"ci" = (/obj/effect/decal/cleanable/blood/tracks,/obj/item/ammo_casing/c9mm,/turf/open/floor/plasteel,/area/space)
"cj" = (/obj/structure/rack,/obj/item/weapon/storage/box/lights/tubes,/obj/item/weapon/storage/toolbox/electrical,/turf/open/floor/plating,/area/space)
"ck" = (/obj/structure/rack,/obj/item/clothing/mask/gas,/turf/open/floor/plating,/area/space)
"cl" = (/obj/structure/rack,/obj/item/clothing/suit/fire/firefighter,/obj/item/weapon/extinguisher,/turf/open/floor/plating,/area/space)
"cm" = (/turf/open/floor/plasteel/darkblue/corner{tag = "icon-darkbluecorners (EAST)"; icon_state = "darkbluecorners"; dir = 4},/area/space)
"cn" = (/obj/structure/girder/reinforced,/turf/open/space,/area/space)
"co" = (/mob/living/simple_animal/hostile/asteroid/hivelord/legion,/turf/open/floor/plasteel,/area/space)
"cp" = (/obj/item/ammo_casing/shotgun/buckshot,/turf/open/floor/plasteel,/area/space)
"cq" = (/obj/structure/sign/directions/evac{tag = "icon-direction_evac (WEST)"; icon_state = "direction_evac"; dir = 8},/turf/closed/wall/r_wall,/area/space)
"cr" = (/obj/structure/sink,/turf/closed/wall/r_wall,/area/space)
"cs" = (/obj/structure/reagent_dispensers/water_cooler,/turf/open/floor/plasteel/darkblue,/area/space)
"ct" = (/obj/structure/table,/obj/item/weapon/hand_labeler,/turf/open/floor/plasteel/darkblue,/area/space)
"cu" = (/obj/structure/frame/computer,/turf/open/floor/plasteel/darkblue,/area/space)
"cv" = (/obj/structure/grille,/obj/structure/window/reinforced/fulltile,/turf/open/space,/area/space)
"cw" = (/obj/structure/girder/reinforced,/obj/effect/decal/cleanable/dirt{desc = "A thin layer of dust coating the floor."; name = "dust"},/turf/open/floor/plating{icon_state = "panelscorched"},/area/space)
"cx" = (/obj/item/ammo_casing/n762,/turf/open/floor/plasteel,/area/space)
"cy" = (/obj/effect/decal/cleanable/blood/tracks{tag = "icon-tracks (NORTH)"; icon_state = "tracks"; dir = 1},/obj/item/ammo_casing/shotgun/buckshot,/turf/open/floor/plasteel,/area/space)
"cz" = (/obj/machinery/door/firedoor/border_only{dir = 8},/turf/open/floor/plasteel/blue/corner{tag = "icon-bluecorner (EAST)"; icon_state = "bluecorner"; dir = 4},/area/space)
"cA" = (/turf/open/floor/plasteel/blue/corner{tag = "icon-bluecorner (EAST)"; icon_state = "bluecorner"; dir = 4},/area/space)
"cB" = (/obj/structure/closet/l3closet,/turf/open/floor/plasteel/blue/corner{tag = "icon-bluecorner (EAST)"; icon_state = "bluecorner"; dir = 4},/area/space)
"cC" = (/obj/structure/sign/biohazard,/turf/closed/wall/r_wall,/area/space)
"cD" = (/obj/machinery/shower{desc = "A showerhead found in school science labs and medbays alike, used to quickly wash off any dangerous fluids covering a person."; name = "emergency shower"; pixel_y = 15},/turf/open/floor/plasteel/white,/area/space)
"cE" = (/turf/open/floor/plasteel/white,/area/space)
"cF" = (/obj/item/weapon/soap/nanotrasen,/obj/structure/table,/turf/open/floor/plasteel/white,/area/space)
"cG" = (/obj/structure/sign/xeno_warning_mining,/turf/closed/wall/r_wall,/area/space)
"cH" = (/obj/item/weapon/shard{icon_state = "small"},/turf/open/floor/plasteel/darkblue/corner{tag = "icon-darkbluecorners (EAST)"; icon_state = "darkbluecorners"; dir = 4},/area/space)
"cI" = (/obj/structure/grille,/obj/item/weapon/shard,/turf/open/floor/plating,/area/space)
"cJ" = (/turf/open/floor/plasteel/darkblue,/area/space)
"cK" = (/obj/item/weapon/paper/scp_research,/turf/open/floor/plating,/area/space)
"cL" = (/mob/living/simple_animal/hostile/asteroid/basilisk/watcher,/turf/open/floor/plating/asteroid/basalt/lava_land_surface,/area/space)
"cM" = (/obj/effect/decal/cleanable/dirt{desc = "A thin layer of dust coating the floor."; name = "dust"},/obj/effect/decal/cleanable/blood/tracks{tag = "icon-tracks (WEST)"; icon_state = "tracks"; dir = 8},/obj/effect/decal/cleanable/blood/gibs/limb,/turf/open/floor/plating{icon_state = "panelscorched"},/area/space)
"cN" = (/obj/effect/decal/cleanable/dirt{desc = "A thin layer of dust coating the floor."; name = "dust"},/obj/effect/decal/cleanable/blood/tracks{tag = "icon-tracks (WEST)"; icon_state = "tracks"; dir = 8},/obj/effect/decal/cleanable/blood,/turf/open/floor/plating{icon_state = "panelscorched"},/area/space)
"cO" = (/obj/effect/decal/cleanable/blood/tracks{tag = "icon-tracks (SOUTHEAST)"; icon_state = "tracks"; dir = 6},/turf/open/floor/plasteel,/area/space)
"cP" = (/obj/machinery/door/firedoor/border_only{dir = 8},/turf/open/floor/plasteel,/area/space)
"cQ" = (/obj/machinery/door/airlock/science,/turf/open/floor/plasteel/white,/area/space)
"cR" = (/obj/item/weapon/folder/blue{name = "Research Notes - Objects 15-20"},/turf/open/floor/plasteel/darkblue,/area/space)
"cS" = (/obj/effect/decal/cleanable/dirt{desc = "A thin layer of dust coating the floor."; name = "dust"},/obj/effect/decal/cleanable/blood,/turf/open/floor/plating{icon_state = "panelscorched"},/area/space)
"cT" = (/turf/open/floor/plasteel/blue/corner{tag = "icon-bluecorner (WEST)"; icon_state = "bluecorner"; dir = 8},/area/space)
"cU" = (/obj/machinery/door/firedoor/border_only{dir = 8},/turf/open/floor/plasteel/blue/corner,/area/space)
"cV" = (/turf/open/floor/plasteel/blue/corner,/area/space)
"cW" = (/obj/structure/closet/radiation,/turf/open/floor/plasteel/blue/corner,/area/space)
"cX" = (/obj/structure/sign/radiation,/turf/closed/wall/r_wall,/area/space)
"cY" = (/obj/effect/decal/cleanable/dirt,/turf/open/floor/plasteel/white,/area/space)
"cZ" = (/obj/structure/sign/science,/turf/closed/wall/r_wall,/area/space)
"da" = (/obj/effect/decal/cleanable/dirt,/turf/open/floor/plasteel/darkblue/corner{tag = "icon-darkbluecorners (EAST)"; icon_state = "darkbluecorners"; dir = 4},/area/space)
"db" = (/obj/structure/grille,/obj/structure/window/fulltile,/turf/open/floor/plating,/area/space)
"dc" = (/obj/machinery/door/airlock/glass{name = "Staff Room"},/turf/open/floor/plasteel{icon_state = "barber"},/area/space)
"dd" = (/obj/machinery/washing_machine,/turf/open/floor/plasteel/whiteblue/side,/area/space)
"de" = (/obj/structure/bedsheetbin,/obj/structure/table,/turf/open/floor/plasteel/whiteblue/side,/area/space)
"df" = (/obj/structure/sign/directions/engineering,/turf/closed/wall/r_wall,/area/space)
"dg" = (/obj/structure/table,/obj/item/weapon/paper_bin,/obj/item/weapon/pen,/turf/open/floor/plating{icon_state = "panelscorched"},/area/space)
"dh" = (/obj/structure/table,/obj/item/weapon/reagent_containers/food/drinks/britcup,/turf/open/floor/plating{icon_state = "panelscorched"},/area/space)
"di" = (/obj/machinery/computer/arcade,/turf/open/floor/plasteel{icon_state = "barber"},/area/space)
"dj" = (/obj/machinery/vending/cigarette,/turf/open/floor/plasteel{icon_state = "barber"},/area/space)
"dk" = (/turf/open/floor/plasteel{icon_state = "barber"},/area/space)
"dl" = (/obj/item/trash/chips,/turf/open/floor/plasteel{icon_state = "barber"},/area/space)
"dm" = (/obj/structure/filingcabinet/chestdrawer,/turf/open/floor/plasteel{icon_state = "barber"},/area/space)
"dn" = (/obj/effect/decal/cleanable/dirt,/obj/item/device/analyzer,/turf/open/floor/plasteel/black,/area/space)
"do" = (/obj/structure/chair,/turf/open/floor/plasteel{icon_state = "barber"},/area/space)
"dp" = (/obj/structure/chair{dir = 4},/turf/open/floor/plasteel{icon_state = "barber"},/area/space)
"dq" = (/obj/structure/table/glass,/turf/open/floor/plasteel{icon_state = "barber"},/area/space)
"dr" = (/obj/structure/table/glass,/obj/item/weapon/paper{info = "\[center]\[large]Anomalous Object Containment \[AOC] Site 21 \[/large]\[/center] \[br] \[center]Status Report on 11. 8. 2489 at 8:09 AM Lavaland Time\[/center] \[br] \[br] Nothing unusual to report. Seismic Warning System's blaring about a quake coming in soon, but Scott told me he'd fix it by the weekend. We've had to reschedule some experiments to the next Wednesday due to some broken equipment, but nothing major to worry about. \[br] Signed: Dr. James Walker"; name = "Status Report"},/turf/open/floor/plasteel{icon_state = "barber"},/area/space)
"ds" = (/obj/structure/table/glass,/obj/item/weapon/paper_bin,/obj/item/weapon/pen,/turf/open/floor/plasteel{icon_state = "barber"},/area/space)
"dt" = (/obj/structure/chair{dir = 8},/turf/open/floor/plasteel{icon_state = "barber"},/area/space)
"du" = (/obj/structure/table/glass,/obj/item/weapon/reagent_containers/food/drinks/coffee,/obj/item/clothing/mask/cigarette,/turf/open/floor/plasteel{icon_state = "barber"},/area/space)
"dv" = (/obj/machinery/status_display,/turf/open/floor/plasteel{icon_state = "barber"},/area/space)
"dw" = (/obj/structure/table/glass,/obj/item/weapon/storage/fancy/donut_box,/turf/open/floor/plasteel{icon_state = "barber"},/area/space)
"dx" = (/obj/item/trash/raisins,/turf/open/floor/plasteel{icon_state = "barber"},/area/space)
"dy" = (/obj/structure/table,/obj/machinery/microwave,/turf/open/floor/plasteel{icon_state = "barber"},/area/space)
"dz" = (/obj/structure/table,/obj/item/weapon/storage/box/donkpockets{pixel_y = 2; pixel_z = 2},/obj/item/weapon/storage/box/donkpockets,/turf/open/floor/plasteel{icon_state = "barber"},/area/space)
"dA" = (/obj/machinery/vending/coffee,/turf/open/floor/plasteel{icon_state = "barber"},/area/space)
"dB" = (/obj/machinery/vending/cola,/turf/open/floor/plasteel{icon_state = "barber"},/area/space)
"dC" = (/obj/machinery/vending/snack,/turf/open/floor/plasteel{icon_state = "barber"},/area/space)
"dD" = (/obj/structure/closet/wardrobe/science_white,/turf/open/floor/plasteel{icon_state = "barber"},/area/space)

(1,1,1) = {"
aaaaaaaaaaaaaaaaaaaaaaaaaaaaaaaaaaaaaaaaaaaaaaaaaaaaaaaaaaaaaaaaaaaaabababababababaaaaaaaaaaaaaaaaaaaaaaaaaaaa
aaaaaaaaaaaaaaaaaaaaaaaaaaaaaaaaaaaaaaaaaaaaaaaaaaaaaaaaaaaaababababababababababababaaaaaaaaaaaaaaaaaaaaaaaaaa
aaaaaaaaaaaaaaaaaaaaaaaaaaaaaaaaaaaaaaaaaaaaaaaaaaaaaaaaabababababababababababababababaaaaaaaaaaaaaaaaaaaaaaaa
aaaaaaaaaaaaaaaaaaaaaaaaaaaaaaaaaaaaaaaaaaaaaaaaaaaaababababababacacacacacacacacacabababaaaaaaaaaaaaaaaaaaaaaa
aaaaaaaaaaaaaaaaaaaaaaaaaaaaaaaaaaaaaaaaaaaaaaaaaaabababababababacadadaeafagahahacabababaaaaaaaaaaaaaaaaaaaaaa
aaaaaaaaaaaaaaaaaaaaaaaaaaaaaaaaaaaaaaaaaaaaaaaaababababababababacaiajakakakalamacababababaaaaaaaaaaaaaaaaaaaa
aaaaaaaaaaaaaaaaaaaaaaaaaaaaaaaaaaaaaaaaaaaaaaababacacabababababacanaoapapapaqaracababababaaaaaaaaaaaaaaaaaaaa
aaaaaaaaaaaaaaaaaaaaaaaaaaaaaaaaaaaaaaaaaaaaaaababacababababasatacanaoapapapaqauacababababaaaaaaaaaaaaaaaaaaaa
aaaaaaaaaaaaaaaaaaaaaaaaaaaaaaaaaaaaaaaaaaaaababababababasasatatavawawawapapaqaxacabababababaaaaaaaaaaaaaaaaaa
aaaaaaaaaaaaaaaaaaaaaaaaaaaaaaaaaaaaaaaaabababababababatatatatatatasasawawapaqayacabababababaaaaaaaaaaaaaaaaaa
aaaaaaaaaaaaaaaaaaaaaaaaaaaaaaaaaaaaaaabababababasatatatatatatatasasasasazawawacacabababababaaaaaaaaaaaaaaaaaa
aaaaaaaaaaaaaaaaaaaaaaaaaaaaaaaaaaaaabababababatatatatatatasasasasasasasasasawatatatabababababaaaaaaaaaaaaaaaa
aaaaaaaaaaaaaaaaaaaaaaaaaaaaaaaaaaabababababatatatatatasababacacacacasasasasasasatatabababababaaaaaaaaaaaaaaaa
aaaaaaaaaaaaaaaaaaaaaaaaaaaaaaaaabababababatatatatatasasabaAaBaCaCaCavaDasasacasasatatabababababaaaaaaaaaaaaaa
aaaaaaaaaaaaaaaaaaaaaaaaaaaaaaabababababasatatatatasasababaEaBaCaCaCawaDapasasasasatatatabababababaaaaaaaaaaaa
aaaaaaaaaaaaaaaaaaaaaaaaaaaaababacababasatatatatasasasababaEaFaGaGaGaHaIapacacaJaJasatatatasababababaaaaaaaaaa
aaaaaaaaaaaaaaaaaaaaaaaaaaabababababatatatatatasasasababaAaEaBaCaCaCawaKapacaEaLacasasatatasasababababaaaaaaaa
aaaaaaaaaaaaaaaaabaaababababababasatatatatatasasasasababaAaBaBaCaCaCavaMaNacaOaEaEacasasatatasasabababaaaaaaaa
aaaaaaaaaaaaabababababababababatatatatatatasasasasasabaAaEaBaCaCaCaCavaDapacaEaEaPacasasasatatasasabababaaaaaa
aaaaaaaaababababababasasasatatatatatatatasasasasasasabababacacacacacacaDapabaEaEaEasasasasasatatatasababaaaaaa
ataaaaababababababasatatatatatatatatasasasasasababababababaQaQaQaQaQaRapapabababababababababababatatabababaaaa
ataaaaaaabababasatatatatatatatababababasasasasabababababaQaQaQaQaSaSababababababababababababababatatabababaaaa
atatatatatababatatabababababababababababababababababacacacacaTavacacacabababacacacacacacababababatatasababaaaa
atatatatababababababababababababababababababababababacaCaCaCaCaCaCaUacabababacaCaCaCaCawavabababatatasabababaa
aaaaaaaaababababacacacaVacacacaAabacacabacacababababacaCaCaCaCaCaCaCacaWabaEacaCaCaXaCaCawawababatatasasababaa
aaasasaaasasasasacaYaZbabbbcbdbdbeaAbfabababababababacaCaCaCbgaCaBaCacbhbiaEacaCaXaXaXaXaXaCacasasatasasababaa
aaasasasasasasasazaQaQaQbjbkblblblblaEabababababababacaCaCaCaCbmaCaCazapbnbnboaCaCaXbpaXaCaCacasatatatasasabaa
aaasasasasasasasbqaQaQbrbjbkbsaQblblbfabababababababacaCaCaCaCbmbmaCacaDapaQacaCaXaXaXaXaXaCacasatatatasasabaa
aaaaasasasbtbubvbwbxbxbybzbAbBbCbsababababababacacabacaCaCaCaCaCaCaCacaDapaQacaCaCaCaXaCaXaCacasatatasasasabaa
aaasasasasasasasbDacacacacacbsbEbsbFacacacacabacbGbHacaCaCaCaCaCaCaCacaDapbIacbJaCaCaCaCaCaCacasasatasasababaa
aaasasasasasasaaabababababacbsbEbsacbKbLbMacabacbNapacacacacacacacacbOaDapbIacacacacacacacacacasatatasababaaaa
aaaaasasasasaaaaaaababababacbPbEbQacbRaQbSacabacbTapacbUapaQapapbnbVapaQapaEbWababababababababasatasasababaaaa
aaaaaaaaaaaaaaaaaaababababacbXbYaQaRaQaQbZacabacbnbnapapapcacbapaQaQapapbnccababababababababasasatatabababaaaa
aaaaaaaaaaaaaaaaabababababacbscdceacaQaQaQacababababacapcfapcgcgcgcgcgchbnaEababababasasasasasatatababaaaaaaaa
aaaaaaaaaaaaaaaaabababababacbscibPaccjckclacababababacapaQcmaccnacacacacacacabababasasasatatatatababaaaaaaaaaa
aaaaaaaaaaaaaaaaabababacabaccobYcpcqacacacacacaccracacaQaQcmaccsctaQcucvabababasasasasatatatatababaaaaaaaaaaaa
aaaaaaaaaaaaabababababababcwcxcybsczcAcAcAcBcCcDcEcFcGbnapcHcIcJcKcJcucvasascLasatatatatatatababaaaaaaaaaaaaaa
aaaaaaaaaaabababababacababcMcNcObscPaQbsblbscQcEcEcEcQapapaQabcRcJcJcucvasasasatatatatatasababaaaaaaaaaaaaaaaa
aaaaaaaaababababababababcwcSbdbscTcUcVaQcVcWcXcEcEcYcZbnbndaabavcJcJcucvasasasatatatababababaaaaaaaaaaaaaaaaaa
aaaaaaababababababababacacacdbdcdbacacacacacacdddddedfbnbnaEabavawdgdhcvasasatatatababaaaaaaaaaaaaaaaaaaaaaaaa
aaaaabababacacacabababacdidjdkdkdldmdmacababacacacacacdnaAababababababababatatatababaaaaaaaaaaaaaaaaaaaaaaaaaa
ababababbdbdbdbdabababacdkdkdodododkdkacababababababacaEaAabababababababatatatababaaaaaaaaaaaaaaaaaaaaaaaaaaaa
ababababacacacacabababacdkdpdqdrdsdtdkacababababababacaAabababababababatatabababaaaaaaaaaaaaaaaaaaaaaaaaaaaaaa
abababababababababababacdkdpdudvdqdtdkacababababababacababababababababababababaaaaaaaaaaaaaaaaaaaaaaaaaaaaaaaa
abababababababababababacdkdpdwdqdqdtdkacabababababababababababaaaaabababababaaaaaaaaaaaaaaaaaaaaaaaaaaaaaaaaaa
aaaaaaaaabababaaabababacdkdkdkdkdkdxdkacabababababababababababaaaaaaaaababaaaaaaaaaaaaaaaaaaaaaaaaaaaaaaaaaaaa
aaaaaaaaaaaaaaaaabababacdydzdAdBdCdDdDacababababababaaaaaaaaaaaaaaaaaaaaaaaaaaaaaaaaaaaaaaaaaaaaaaaaaaaaaaaaaa
aaaaaaaaaaaaaaaaabababacacacacacacacacacababababaaaaaaaaaaaaaaaaaaaaaaaaaaaaaaaaaaaaaaaaaaaaaaaaaaaaaaaaaaaaaa
aaaaaaaaaaaaaaaaabababababababababababababababaaaaaaaaaaaaaaaaaaaaaaaaaaaaaaaaaaaaaaaaaaaaaaaaaaaaaaaaaaaaaaaa
aaaaaaaaaaaaaaaaababababababababababababababaaaaaaaaaaaaaaaaaaaaaaaaaaaaaaaaaaaaaaaaaaaaaaaaaaaaaaaaaaaaaaaaaa
"}
