//MAP CONVERTED BY dmm2tgm.py THIS HEADER COMMENT PREVENTS RECONVERSION, DO NOT REMOVE 
"aa" = (
/turf/template_noop,
/area/lavaland/surface/outdoors)
"ab" = (
/turf/open/floor/plating/lava/smooth/lava_land_surface,
/area/lavaland/surface/outdoors)
"ac" = (
/turf/closed/mineral/volcanic,
/area/lavaland/surface/outdoors)
"ad" = (
/turf/closed/wall/r_wall,
/area/ruin/unpowered)
"ae" = (
/obj/structure/bed,
/obj/item/weapon/bedsheet/red,
/turf/open/floor/pod,
/area/ruin/unpowered)
"af" = (
/obj/structure/bed,
/obj/item/weapon/bedsheet/red,
/obj/effect/mob_spawn/human/corpse/russian,
/turf/open/floor/pod,
/area/ruin/unpowered)
"ag" = (
/obj/effect/mob_spawn/human/corpse/russian,
/turf/open/floor/pod,
/area/ruin/unpowered)
"ah" = (
/obj/machinery/light{
	dir = 1
	},
/turf/open/floor/pod,
/area/ruin/unpowered)
"ai" = (
/turf/open/floor/pod,
/area/ruin/unpowered)
"aj" = (
/obj/structure/table,
/obj/item/weapon/razor,
/turf/open/floor/pod,
/area/ruin/unpowered)
"ak" = (
/obj/structure/table,
/obj/item/weapon/wirerod,
/turf/open/floor/pod,
/area/ruin/unpowered)
"al" = (
/obj/structure/table,
/obj/item/weapon/surgicaldrill,
/turf/open/floor/pod,
/area/ruin/unpowered)
"am" = (
/obj/machinery/light{
	icon_state = "tube1";
	dir = 8
	},
/turf/open/floor/pod,
/area/ruin/unpowered)
"an" = (
/obj/effect/decal/cleanable/blood/splatter,
/turf/open/floor/pod,
/area/ruin/unpowered)
"ao" = (
/obj/structure/bed,
/turf/open/floor/pod,
/area/ruin/unpowered)
"ap" = (
/obj/effect/decal/cleanable/blood/drip,
/turf/open/floor/pod,
/area/ruin/unpowered)
"aq" = (
/obj/item/ammo_casing/a357,
/obj/effect/decal/cleanable/blood/drip,
/obj/effect/decal/cleanable/blood/tracks,
/turf/open/floor/pod,
/area/ruin/unpowered)
"ar" = (
/obj/item/chair,
/obj/effect/decal/cleanable/blood,
/obj/effect/mob_spawn/human/corpse/damaged,
/turf/open/floor/pod,
/area/ruin/unpowered)
"as" = (
/obj/structure/bed,
/obj/item/weapon/bedsheet/brown,
/turf/open/floor/pod,
/area/ruin/unpowered)
"at" = (
/obj/machinery/door/airlock/hatch,
/turf/open/floor/pod,
/area/ruin/unpowered)
"au" = (
/obj/item/weapon/restraints/handcuffs,
/turf/open/floor/pod,
/area/ruin/unpowered)
"av" = (
/obj/effect/mob_spawn/human/corpse/russian,
/obj/effect/decal/cleanable/blood/old,
/turf/open/floor/pod,
/area/ruin/unpowered)
"aw" = (
/obj/structure/table/reinforced,
/obj/item/weapon/reagent_containers/food/snacks/burger/bearger,
/obj/item/weapon/reagent_containers/food/snacks/burger/bearger,
/obj/item/weapon/reagent_containers/food/snacks/burger/bearger,
/turf/open/floor/pod,
/area/ruin/unpowered)
"ax" = (
/obj/structure/table/reinforced,
/obj/item/weapon/reagent_containers/food/snacks/bearsteak,
/obj/item/weapon/reagent_containers/food/snacks/bearsteak,
/turf/open/floor/pod,
/area/ruin/unpowered)
"ay" = (
/obj/machinery/light{
	dir = 4
	},
/turf/open/floor/pod,
/area/ruin/unpowered)
"az" = (
/obj/structure/table,
/obj/item/weapon/circular_saw,
/turf/open/floor/pod,
/area/ruin/unpowered)
"aA" = (
/obj/structure/table,
/obj/item/weapon/kitchen/knife/butcher,
/turf/open/floor/pod,
/area/ruin/unpowered)
"aB" = (
/obj/structure/table,
/obj/item/weapon/kitchen/knife/combat,
/turf/open/floor/pod,
/area/ruin/unpowered)
"aC" = (
/obj/structure/table/reinforced,
/obj/item/clothing/gloves/space_ninja,
/turf/open/floor/pod,
/area/ruin/unpowered)
"aD" = (
/obj/structure/table/reinforced,
/obj/item/clothing/shoes/space_ninja,
/turf/open/floor/pod,
/area/ruin/unpowered)
"aE" = (
/obj/machinery/porta_turret/syndicate,
/turf/open/floor/pod,
/area/ruin/unpowered)
"aF" = (
/obj/machinery/light{
	dir = 4
	},
/obj/effect/decal/cleanable/blood/splatter,
/turf/open/floor/pod,
/area/ruin/unpowered)
"aG" = (
/obj/effect/decal/cleanable/blood/splatter,
/turf/closed/wall/r_wall,
/area/ruin/unpowered)
"aH" = (
/obj/machinery/light{
	icon_state = "tube1";
	dir = 8
	},
/obj/structure/table/reinforced,
/obj/item/clothing/head/helmet/space/space_ninja,
/obj/item/clothing/mask/gas/space_ninja{
	icon_state = "s-ninjak"
	},
/turf/open/floor/pod,
/area/ruin/unpowered)
"aI" = (
/obj/machinery/door/airlock/hatch{
	locked = 1
	},
/turf/open/floor/pod,
/area/ruin/unpowered)
"aJ" = (
/obj/effect/mob_spawn/human/corpse/damaged,
/obj/effect/decal/cleanable/blood/splatter,
/mob/living/simple_animal/hostile/bear/Hudson{
	desc = "What's Hudson doing in this hellscape?"
	},
/turf/open/floor/pod,
/area/ruin/unpowered)
"aK" = (
/obj/machinery/door/airlock/hatch{
	locked = 1
	},
/obj/effect/decal/cleanable/blood/splatter,
/turf/open/floor/pod,
/area/ruin/unpowered)
"aL" = (
/obj/effect/mob_spawn/human/corpse/nanotrasensoldier,
/turf/open/floor/pod,
/area/ruin/unpowered)
"aM" = (
/obj/item/ammo_casing/a357,
/turf/open/floor/pod,
/area/ruin/unpowered)
"aN" = (
/obj/structure/table/reinforced,
/obj/item/clothing/suit/space/space_ninja{
	icon_state = "s-ninjak"
	},
/turf/open/floor/pod,
/area/ruin/unpowered)
"aO" = (
/obj/structure/table/reinforced,
/turf/open/floor/pod,
/area/ruin/unpowered)
"aP" = (
/obj/structure/table/wood,
/obj/item/weapon/reagent_containers/food/drinks/bottle/vodka,
/obj/item/weapon/reagent_containers/food/drinks/bottle/vodka/badminka{
	pixel_x = 6;
	pixel_y = 3
	},
/obj/item/weapon/reagent_containers/food/drinks/bottle/vodka/badminka{
	pixel_x = -9;
	pixel_y = -4
	},
/turf/open/floor/pod,
/area/ruin/unpowered)
"aQ" = (
/obj/machinery/light{
	dir = 4
	},
/obj/item/ammo_casing/a357{
	pixel_x = -5;
	pixel_y = 8
	},
/obj/item/ammo_casing/a357,
/mob/living/simple_animal/hostile/bear,
/turf/open/floor/pod,
/area/ruin/unpowered)
"aR" = (
/obj/structure/table/reinforced,
/obj/item/weapon/reagent_containers/food/snacks/meat/slab/bear,
/obj/item/weapon/reagent_containers/food/snacks/meat/slab/bear,
/obj/item/weapon/reagent_containers/food/snacks/meat/slab/bear,
/obj/item/weapon/reagent_containers/food/snacks/pie/bearypie,
/turf/open/floor/pod,
/area/ruin/unpowered)
"aS" = (
/obj/structure/table/reinforced,
/obj/item/clothing/head/bearpelt,
/turf/open/floor/pod,
/area/ruin/unpowered)
"aT" = (
/obj/structure/table/reinforced,
/obj/item/weapon/reagent_containers/food/snacks/meat/steak/bear,
/obj/item/weapon/reagent_containers/food/snacks/meat/steak/bear,
/obj/item/weapon/reagent_containers/food/snacks/pie/bearypie,
/turf/open/floor/pod,
/area/ruin/unpowered)
"aU" = (
/obj/structure/table/wood,
/obj/item/weapon/reagent_containers/food/drinks/bottle/vodka/badminka,
/obj/item/weapon/gun/projectile/revolver,
/turf/open/floor/pod,
/area/ruin/unpowered)
"aV" = (
/obj/structure/chair{
	dir = 8;
	name = "chair"
	},
/obj/effect/mob_spawn/human/corpse/russian/ranged/officer,
/obj/effect/decal/cleanable/blood/old,
/turf/open/floor/pod,
/area/ruin/unpowered)
"aW" = (
/obj/effect/decal/cleanable/blood/old,
/turf/open/floor/pod,
/area/ruin/unpowered)
"aX" = (
/obj/structure/table,
/obj/item/clothing/mask/gas/sexyclown,
/turf/open/floor/pod,
/area/ruin/unpowered)
"aY" = (
/obj/structure/table,
/obj/item/clothing/mask/gas/explorer,
/turf/open/floor/pod,
/area/ruin/unpowered)
"aZ" = (
/obj/item/weapon/cigbutt/cigarbutt,
/turf/open/floor/pod,
/area/ruin/unpowered)
"ba" = (
/obj/structure/table,
/obj/item/clothing/mask/gas/syndicate,
/turf/open/floor/pod,
/area/ruin/unpowered)
"bb" = (
/obj/item/chair{
	dir = 4
	},
/turf/open/floor/pod,
/area/ruin/unpowered)
"bc" = (
/obj/structure/table,
/turf/open/floor/pod,
/area/ruin/unpowered)
"bd" = (
/obj/item/chair,
/turf/open/floor/pod,
/area/ruin/unpowered)
"be" = (
/obj/structure/table_frame,
/turf/open/floor/pod,
/area/ruin/unpowered)
"bf" = (
/obj/structure/table,
/obj/item/weapon/crowbar/red,
/turf/open/floor/pod,
/area/ruin/unpowered)
"bg" = (
/obj/item/stack/rods,
/turf/open/floor/pod,
/area/ruin/unpowered)
"bh" = (
/obj/item/weapon/broken_bottle,
/turf/open/floor/pod,
/area/ruin/unpowered)
"bi" = (
/obj/item/stack/sheet/metal,
/turf/open/floor/pod,
/area/ruin/unpowered)
"bj" = (
/obj/item/weapon/wrench,
/turf/open/floor/pod,
/area/ruin/unpowered)
"bk" = (
/obj/structure/table,
/obj/item/clothing/mask/facehugger/toy,
/turf/open/floor/pod,
/area/ruin/unpowered)
"bl" = (
/obj/machinery/light,
/turf/open/floor/pod,
/area/ruin/unpowered)
"bm" = (
/obj/structure/table_frame,
/obj/item/stack/rods,
/turf/open/floor/pod,
/area/ruin/unpowered)
"bn" = (
/obj/structure/table,
/obj/item/weapon/stock_parts/matter_bin/bluespace,
/turf/open/floor/pod,
/area/ruin/unpowered)
"bo" = (
/obj/structure/table,
/obj/item/clothing/head/helmet/skull,
/turf/open/floor/pod,
/area/ruin/unpowered)
"bp" = (
/obj/machinery/keycard_auth{
	pixel_y = -7
	},
/turf/closed/wall/r_wall,
/area/ruin/unpowered)
"bq" = (
/obj/machinery/space_heater,
/turf/open/floor/pod,
/area/ruin/unpowered)
"br" = (
/obj/effect/decal/cleanable/blood/drip,
/obj/effect/mob_spawn/human/corpse/nanotrasensoldier,
/turf/open/floor/pod,
/area/ruin/unpowered)
"bs" = (
/obj/machinery/suit_storage_unit/standard_unit,
/turf/open/floor/pod,
/area/ruin/unpowered)
"bt" = (
/obj/machinery/shower{
	dir = 4
	},
/turf/open/floor/pod,
/area/ruin/unpowered)
"bu" = (
/obj/machinery/shower{
	dir = 8
	},
/turf/open/floor/pod,
/area/ruin/unpowered)
"bv" = (
/turf/open/floor/plating,
/area/ruin/unpowered)
"bw" = (
/turf/open/floor/plating{
	icon_state = "platingdmg1"
	},
/area/ruin/unpowered)
"bx" = (
/obj/machinery/door/poddoor,
/turf/open/floor/pod,
/area/ruin/unpowered)
"by" = (
/obj/structure/barricade/sandbags,
/turf/open/floor/pod,
/area/lavaland/surface/outdoors)
"bz" = (
/turf/open/floor/plating{
	icon_state = "platingdmg3"
	},
/area/lavaland/surface/outdoors)
"bA" = (
/turf/open/floor/pod,
/area/lavaland/surface/outdoors)
"bB" = (
/obj/effect/mob_spawn/human/corpse/russian,
/obj/effect/decal/cleanable/blood/old,
/turf/open/floor/pod,
/area/lavaland/surface/outdoors)
"bD" = (
/mob/living/simple_animal/hostile/viscerator,
/mob/living/simple_animal/hostile/viscerator,
/mob/living/simple_animal/hostile/viscerator,
/mob/living/simple_animal/hostile/viscerator,
/mob/living/simple_animal/hostile/viscerator,
/mob/living/simple_animal/hostile/viscerator,
/mob/living/simple_animal/hostile/viscerator,
/mob/living/simple_animal/hostile/viscerator,
/turf/open/floor/pod,
/area/ruin/unpowered)
"bC" = (
/mob/living/simple_animal/hostile/bear,
/turf/open/floor/pod,
/area/ruin/unpowered)

(1,1,1) = {"
aa
aa
aa
aa
aa
aa
aa
aa
aa
aa
aa
aa
aa
aa
aa
aa
aa
aa
aa
aa
aa
aa
aa
aa
aa
aa
aa
aa
aa
aa
aa
aa
aa
aa
aa
"}
(2,1,1) = {"
aa
aa
aa
aa
aa
aa
aa
aa
aa
aa
aa
aa
aa
aa
aa
aa
aa
aa
aa
aa
aa
aa
aa
aa
aa
aa
aa
aa
aa
aa
aa
aa
aa
aa
aa
"}
(3,1,1) = {"
aa
aa
aa
aa
aa
aa
aa
aa
aa
aa
aa
aa
aa
aa
aa
aa
aa
aa
aa
aa
aa
aa
aa
aa
aa
aa
aa
aa
aa
aa
aa
aa
aa
aa
aa
"}
(4,1,1) = {"
aa
aa
aa
aa
aa
aa
aa
aa
aa
aa
aa
aa
aa
aa
aa
aa
aa
aa
aa
aa
aa
aa
aa
aa
aa
aa
aa
aa
aa
aa
aa
aa
aa
aa
aa
"}
(5,1,1) = {"
aa
aa
aa
aa
aa
aa
aa
aa
aa
aa
aa
aa
aa
aa
aa
aa
aa
aa
aa
aa
aa
aa
aa
aa
aa
aa
aa
aa
aa
aa
aa
aa
aa
aa
aa
"}
(6,1,1) = {"
aa
aa
aa
aa
aa
aa
aa
aa
aa
aa
ab
ab
ab
ab
ab
ab
aa
aa
aa
aa
aa
aa
aa
aa
aa
aa
aa
aa
aa
aa
aa
aa
aa
aa
aa
"}
(7,1,1) = {"
aa
aa
aa
aa
aa
aa
aa
aa
ab
ab
ab
ab
ab
ab
ab
ab
ab
aa
aa
aa
aa
aa
aa
aa
aa
aa
aa
aa
aa
aa
aa
aa
aa
aa
aa
"}
(8,1,1) = {"
aa
aa
aa
ab
ab
ab
ab
ac
ab
ad
ad
ad
ad
ad
ad
ad
ab
ab
ac
ab
aa
aa
aa
aa
aa
aa
aa
aa
aa
aa
aa
aa
aa
aa
aa
"}
(9,1,1) = {"
aa
aa
aa
ac
ab
ab
ac
ac
ab
ad
ad
ad
ad
ad
ad
ad
ab
ac
ac
ab
ab
ac
ac
ac
aa
aa
aa
aa
aa
aa
aa
aa
aa
aa
aa
"}
(10,1,1) = {"
aa
aa
aa
ac
ab
ab
ac
ab
ab
ad
ad
aC
aH
aN
ad
ad
ab
ab
ab
ab
ab
ab
ab
aa
aa
aa
aa
aa
ac
aa
aa
aa
aa
aa
aa
"}
(11,1,1) = {"
aa
ab
ab
ab
ab
ab
ab
ab
ab
ad
ad
aD
bD
aO
ad
ad
ad
ad
ad
ad
ad
ad
ab
ab
ac
ac
ab
ab
ac
aa
aa
aa
aa
aa
aa
"}
(12,1,1) = {"
aa
ab
ac
ab
ad
ad
ad
ad
ad
ad
ad
ad
aI
ad
ad
ad
ai
ai
ai
ai
ai
ad
ab
ab
ac
ab
ab
ab
ac
aa
aa
aa
aa
aa
aa
"}
(13,1,1) = {"
aa
ac
ac
ab
ad
ae
am
ao
as
ad
aw
aE
ai
aE
aR
ad
ai
ai
bb
ai
ai
ad
ab
ab
ab
ab
ab
ac
ac
aa
aa
aa
aa
aa
aa
"}
(14,1,1) = {"
aa
ab
ac
ab
ad
af
ai
bC
ai
ad
ax
ai
aJ
ai
aS
ad
ah
ai
bc
ai
bl
ad
ab
ab
ab
ab
ab
ac
by
by
by
by
aa
aa
aa
"}
(15,1,1) = {"
aa
ab
ab
ab
ad
ae
ai
ae
ai
ad
ax
aF
an
aF
aT
ad
ai
ai
bd
aZ
ai
ad
ad
ad
ad
ad
ad
ad
bz
bA
bA
by
aa
aa
aa
"}
(16,1,1) = {"
aa
ab
ab
ab
ad
ad
ad
ad
at
ad
ad
aG
aK
aG
ad
ad
ai
ai
be
bi
bc
ad
bq
bs
ad
bt
bv
bw
bz
bA
bA
by
aa
aa
aa
"}
(17,1,1) = {"
aa
ac
ac
ab
ad
ag
ai
ai
ai
ai
am
ai
ai
ai
av
ad
ai
av
bc
bj
ai
ad
ah
ai
ad
ai
ai
ad
bA
bB
bA
by
aa
aa
aa
"}
(18,1,1) = {"
aa
ac
ac
ab
ad
ah
ai
ai
ai
av
ai
ai
aL
ai
ai
at
aW
ai
bf
ai
ai
at
br
ap
at
av
ai
bx
bA
bA
bA
by
aa
aa
aa
"}
(19,1,1) = {"
aa
ab
ab
ab
ad
ai
ai
ai
ai
ai
ay
ai
ai
ai
ai
ad
ai
ai
bg
bi
bm
bp
ap
bl
ad
ah
ai
ad
bB
bA
bA
by
aa
aa
aa
"}
(20,1,1) = {"
aa
ab
ab
ab
ad
ad
ad
ad
at
ad
ad
ad
ad
at
ad
ad
ai
aZ
bh
ai
ai
ad
bs
ai
ad
bu
bu
ad
bA
bA
bA
by
aa
aa
aa
"}
(21,1,1) = {"
aa
ab
ac
ac
ad
aj
ai
ap
ai
ai
az
ad
ai
ai
bC
ad
ai
ai
ai
ai
ai
ad
ad
ad
ad
ad
ad
ad
bA
bA
bA
by
aa
aa
aa
"}
(22,1,1) = {"
aa
ab
ac
ac
ad
ak
an
aq
ap
ai
aA
ad
bC
aP
aU
ad
ah
ai
ai
ai
bl
ad
ab
ab
ab
ab
ab
ac
by
by
by
by
aa
aa
aa
"}
(23,1,1) = {"
aa
ab
ab
ac
ad
al
ai
ar
au
ai
aB
ad
aM
aQ
aV
ad
aX
ai
ai
ai
bn
ad
ab
ac
ac
ac
ab
ac
ac
aa
aa
aa
aa
aa
aa
"}
(24,1,1) = {"
aa
ab
ab
ac
ad
ad
ad
ad
ad
ad
ad
ad
ad
ad
ad
ad
aY
ba
ai
bk
bo
ad
ab
ab
ab
ab
ab
ab
ac
aa
aa
aa
aa
aa
aa
"}
(25,1,1) = {"
aa
ab
ab
ac
ab
ab
ac
ac
ab
ab
ab
ab
ab
ab
ab
ad
ad
ad
ad
ad
ad
ad
ab
ac
ab
ab
ab
ab
ac
aa
aa
aa
aa
aa
aa
"}
(26,1,1) = {"
aa
aa
ab
ab
ab
ab
ab
ab
ab
ab
ab
ab
ab
ac
ab
ab
ab
ab
ab
ab
ab
ab
ab
ac
aa
aa
aa
aa
ac
aa
aa
aa
aa
aa
aa
"}
(27,1,1) = {"
aa
aa
aa
aa
aa
aa
aa
aa
aa
aa
aa
ac
ac
ac
ab
ab
ab
ab
ac
ac
ab
ab
ab
ab
aa
aa
aa
aa
aa
aa
aa
aa
aa
aa
aa
"}
(28,1,1) = {"
aa
aa
aa
aa
aa
aa
aa
aa
aa
aa
aa
aa
aa
aa
aa
aa
aa
aa
aa
aa
aa
aa
aa
aa
aa
aa
aa
aa
aa
aa
aa
aa
aa
aa
aa
"}
(29,1,1) = {"
aa
aa
aa
aa
aa
aa
aa
aa
aa
aa
aa
aa
aa
aa
aa
aa
aa
aa
aa
aa
aa
aa
aa
aa
aa
aa
aa
aa
aa
aa
aa
aa
aa
aa
aa
"}
(30,1,1) = {"
aa
aa
aa
aa
aa
aa
aa
aa
aa
aa
aa
aa
aa
aa
aa
aa
aa
aa
aa
aa
aa
aa
aa
aa
aa
aa
aa
aa
aa
aa
aa
aa
aa
aa
aa
"}
(31,1,1) = {"
aa
aa
aa
aa
aa
aa
aa
aa
aa
aa
aa
aa
aa
aa
aa
aa
aa
aa
aa
aa
aa
aa
aa
aa
aa
aa
aa
aa
aa
aa
aa
aa
aa
aa
aa
"}
(32,1,1) = {"
aa
aa
aa
aa
aa
aa
aa
aa
aa
aa
aa
aa
aa
aa
aa
aa
aa
aa
aa
aa
aa
aa
aa
aa
aa
aa
aa
aa
aa
aa
aa
aa
aa
aa
aa
"}
(33,1,1) = {"
aa
aa
aa
aa
aa
aa
aa
aa
aa
aa
aa
aa
aa
aa
aa
aa
aa
aa
aa
aa
aa
aa
aa
aa
aa
aa
aa
aa
aa
aa
aa
aa
aa
aa
aa
"}
(34,1,1) = {"
aa
aa
aa
aa
aa
aa
aa
aa
aa
aa
aa
aa
aa
aa
aa
aa
aa
aa
aa
aa
aa
aa
aa
aa
aa
aa
aa
aa
aa
aa
aa
aa
aa
aa
aa
"}
(35,1,1) = {"
aa
aa
aa
aa
aa
aa
aa
aa
aa
aa
aa
aa
aa
aa
aa
aa
aa
aa
aa
aa
aa
aa
aa
aa
aa
aa
aa
aa
aa
aa
aa
aa
aa
aa
aa
"}
