"a" = (/turf/closed/indestructible/fakeglass,/obj/item/weapon/gun/projectile/automatic/c20r/sc_c20r)
"b" = (/obj/machinery/field/containment,/mob/living/simple_animal/hostile/asteroid/hivelord/legion,/obj/item/weapon/gun/projectile/revolver/mateba)
"c" = (/mob/living/simple_animal/hostile/asteroid/hivelord,/area/ruin/onehalf/dorms_med)
"d" = (/obj/machinery/mineral/unloading_machine,/mob/living/simple_animal/butterfly,/obj/item/weapon/gun/projectile/automatic/c20r/sc_c20r)
"e" = (/mob/living/simple_animal/butterfly,/obj/item/weapon/gun/projectile/automatic/c20r/sc_c20r)
"f" = (/obj/item/weapon/gun/energy/pulse/loyalpin,/obj/item/weapon/gun/projectile/automatic/c20r/sc_c20r)
"g" = (/obj/machinery/field/containment,/mob/living/simple_animal/butterfly,/obj/item/weapon/gun/projectile/revolver/mateba)
"h" = (/mob/living/simple_animal/hostile/asteroid/hivelord/legion,/obj/item/weapon/gun/projectile/automatic/c20r/sc_c20r)
"i" = (/turf/open/space,/obj/item/weapon/gun/projectile/automatic/c20r/sc_c20r)
"j" = (/obj/machinery/status_display,/mob/living/simple_animal/butterfly,/obj/item/weapon/gun/projectile/automatic/c20r/sc_c20r)
"k" = (/obj/machinery/shower,/mob/living/simple_animal/butterfly,/obj/item/weapon/gun/projectile/automatic/c20r/sc_c20r)
"l" = (/obj/structure/particle_accelerator/fuel_chamber,/mob/living/simple_animal/butterfly,/obj/item/weapon/gun/projectile/automatic/c20r/sc_c20r)
"m" = (/mob/living/simple_animal/butterfly,/obj/item/weapon/twohanded/bonespear)

(1,1,1) = {"
aaaaaaaaabaaaaaaaaac
adeeeeeeeeeeeeeeedac
aeeeeeeeeeeeeeeeeeac
aeeeeeeeeeeeeeeeeeac
aeeefffffgfffffeeeac
aeeefhhhfefhhifeeeac
aeeefhfffgfffifeeeac
aeeefffjeeekfffeeeac
beeegegeeleegegeeebc
aeeefffeeeeefffeeeac
aeeefhfffgfffifeeeac
aeeefhhhfmfhhifeeeac
aeeefffffgfffffeeeac
aeeeeeeeeeeeeeeeeeac
aeeeeeeeeeeeeeeeeeac
adeeeeeeeeeeeeeeedac
aaaaaaaaabaaaaaaaaac
cccccccccccccccccccc
cccccccccccccccccccc
cccccccccccccccccccc
"}
