"aa" = (/turf/open/space,/area/space)
"ab" = (/obj/docking_port/stationary{dwidth = 4; height = 10; id = "mining_distress"; name = "DISTRESS Signal"; width = 10},/turf/open/space,/area/space)
"ac" = (/turf/closed/wall/shuttle{tag = "icon-wall3 (WEST)"; icon_state = "wall3"; dir = 8; layer = 2},/area/ruin/powered)
"ad" = (/obj/machinery/door/airlock/external,/turf/open/floor/plasteel,/area/ruin/powered)
"ae" = (/turf/open/space,/turf/closed/wall/shuttle{tag = "icon-wall3 (NORTHWEST)"; icon_state = "wall3"; dir = 9},/area/ruin/powered)
"af" = (/turf/open/floor/plasteel,/area/ruin/powered)
"ag" = (/turf/open/space,/turf/closed/wall/shuttle{tag = "icon-wall3 (NORTHEAST)"; icon_state = "wall3"; dir = 5; layer = 2},/area/ruin/powered)
"ah" = (/obj/structure/closet/crate{icon_state = "crateopen"; opened = 1},/obj/item/stack/sheet/mineral/diamond,/obj/item/stack/sheet/mineral/bananium,/obj/item/stack/sheet/mineral/gold{pixel_y = 8},/obj/item/stack/sheet/mineral/mythril,/obj/item/stack/sheet/mineral/uranium,/turf/open/floor/plasteel,/area/ruin/powered)
"ai" = (/mob/living/simple_animal/hostile/pirate/ranged,/turf/open/floor/plasteel,/area/ruin/powered)
"aj" = (/obj/structure/bed,/obj/item/weapon/bedsheet/black,/turf/open/floor/plasteel,/area/ruin/powered)
"ak" = (/obj/structure/frame/computer,/turf/open/floor/plasteel,/area/ruin/powered)
"al" = (/obj/structure/chair{dir = 8},/mob/living/simple_animal/hostile/pirate,/turf/open/floor/plasteel,/area/ruin/powered)
"am" = (/obj/structure/rack,/obj/item/weapon/storage/bag/money,/turf/open/floor/plasteel,/area/ruin/powered)
"an" = (/obj/structure/closet,/obj/item/clothing/under/pirate,/obj/item/clothing/suit/pirate,/obj/item/clothing/head/helmet/space/pirate,/obj/item/clothing/shoes/jackboots,/turf/open/floor/plasteel,/area/ruin/powered)
"ao" = (/obj/structure/shuttle/engine/propulsion{icon_state = "propulsion"; dir = 4},/turf/open/floor/plating/airless,/area/ruin/powered)
"ap" = (/obj/structure/shuttle/engine/heater{icon_state = "heater"; dir = 8},/obj/structure/window{icon_state = "window"; dir = 4},/turf/open/floor/plating/airless,/area/ruin/powered)
"aq" = (/obj/structure/closet/crate/secure/loot,/turf/open/floor/plasteel,/area/ruin/powered)
"ar" = (/obj/structure/table,/mob/living/simple_animal/parrot,/turf/open/floor/plasteel,/area/ruin/powered)
"as" = (/obj/effect/spawner/structure/window/reinforced,/turf/open/space,/area/ruin/powered)
"at" = (/obj/structure/chair{dir = 4},/mob/living/simple_animal/hostile/pirate,/turf/open/floor/plasteel,/area/ruin/powered)
"au" = (/obj/effect/spawner/lootdrop/crate_spawner,/turf/open/floor/plasteel,/area/ruin/powered)
"av" = (/obj/structure/table,/turf/open/floor/plasteel,/area/ruin/powered)
"aw" = (/obj/effect/spawner/lootdrop/gambling,/turf/open/floor/plasteel,/area/ruin/powered)
"ax" = (/mob/living/simple_animal/hostile/pirate,/turf/open/floor/plasteel,/area/ruin/powered)
"ay" = (/obj/structure/chair,/mob/living/simple_animal/hostile/pirate,/turf/open/floor/plasteel,/area/ruin/powered)
"az" = (/obj/effect/spawner/lootdrop/armory_contraband,/turf/open/floor/plasteel,/area/ruin/powered)
"aA" = (/obj/structure/closet/emcloset,/turf/open/floor/plasteel,/area/ruin/powered)
"aB" = (/obj/structure/table,/obj/item/weapon/storage/bag/money,/turf/open/floor/plasteel,/area/ruin/powered)
"aC" = (/obj/structure/table,/obj/item/weapon/paper_bin{pixel_x = 1; pixel_y = 7},/obj/item/weapon/pen{pixel_y = 8},/turf/open/floor/plasteel,/area/ruin/powered)
"aD" = (/obj/structure/table,/obj/item/stack/sheet/mineral/gold{pixel_y = 0},/obj/item/stack/sheet/mineral/gold{pixel_y = 0},/turf/open/floor/plasteel,/area/ruin/powered)
"aE" = (/turf/closed/wall,/area/ruin/powered)
"aF" = (/obj/structure/chair{dir = 8},/turf/open/floor/plasteel,/area/ruin/powered)
"aG" = (/turf/open/space,/turf/closed/wall/shuttle{tag = "icon-wall3 (SOUTHWEST)"; icon_state = "wall3"; dir = 10; layer = 2},/area/ruin/powered)
"aH" = (/turf/open/space,/turf/closed/wall/shuttle{tag = "icon-wall3 (SOUTHEAST)"; icon_state = "wall3"; dir = 6},/area/ruin/powered)
"aI" = (/turf/closed/wall/shuttle,/area/ruin/powered)
"aJ" = (/obj/machinery/door/poddoor{id = "thunderdomegen"; name = "General Supply"},/turf/open/space,/area/ruin/powered)
"aK" = (/turf/open/space,/turf/open/floor/plating/airless{broken = 1; icon_state = "platingdmg2"},/area/ruin/powered)
"aL" = (/turf/open/space,/turf/closed/wall/shuttle{dir = 3; icon_state = "swall_f10"; layer = 2},/area/ruin/powered)
"aM" = (/obj/structure/shuttle/engine/heater{icon_state = "heater"; dir = 8},/obj/structure/window/reinforced{dir = 4},/turf/open/floor/plating/airless,/area/ruin/powered)
"aN" = (/obj/structure/chair{tag = "icon-chair (EAST)"; icon_state = "chair"; dir = 4},/obj/structure/window/reinforced{dir = 8},/mob/living/simple_animal/hostile/nanotrasen/ranged,/turf/open/floor/plasteel/shuttle/white,/area/ruin/powered)
"aO" = (/turf/open/floor/plasteel/shuttle/white,/area/ruin/powered)
"aP" = (/mob/living/simple_animal/hostile/pirate,/turf/open/floor/plasteel/shuttle/white,/area/ruin/powered)
"aQ" = (/obj/item/stack/sheet/metal,/obj/item/stack/sheet/metal,/obj/item/stack/sheet/metal,/obj/effect/decal/cleanable/ash,/turf/open/floor/plasteel/shuttle/white,/area/ruin/powered)
"aR" = (/obj/structure/window/reinforced{dir = 8},/obj/structure/window/reinforced{dir = 8},/turf/open/floor/plasteel/shuttle/white,/area/ruin/powered)
"aS" = (/obj/effect/decal/cleanable/ash,/turf/open/floor/plasteel/shuttle/white,/area/ruin/powered)
"aT" = (/obj/effect/decal/cleanable/ash,/obj/structure/chair{dir = 1},/mob/living/simple_animal/hostile/nanotrasen/ranged,/turf/open/floor/plasteel/shuttle/white,/area/ruin/powered)
"aU" = (/obj/structure/table,/turf/open/floor/plasteel/shuttle/white,/area/ruin/powered)
"aV" = (/obj/structure/window/shuttle,/obj/structure/grille,/turf/open/space,/area/ruin/powered)
"aW" = (/obj/structure/window/reinforced{dir = 8},/turf/open/floor/plasteel/shuttle/white,/area/ruin/powered)
"aX" = (/obj/structure/door_assembly/door_assembly_shuttle,/turf/open/space,/area/ruin/powered)
"aY" = (/obj/structure/chair{tag = "icon-chair (EAST)"; icon_state = "chair"; dir = 4},/obj/structure/window/reinforced{dir = 8},/obj/structure/window/reinforced{dir = 8},/turf/open/floor/plasteel/shuttle/white,/area/ruin/powered)
"aZ" = (/obj/structure/chair{tag = "icon-chair (EAST)"; icon_state = "chair"; dir = 4},/turf/open/floor/plasteel/shuttle/white,/area/ruin/powered)
"ba" = (/obj/structure/frame/computer,/turf/open/floor/plasteel/shuttle/white,/area/ruin/powered)
"bb" = (/obj/structure/window/reinforced{dir = 8},/obj/structure/closet/crate/secure/weapon,/turf/open/floor/plasteel/shuttle/white,/area/ruin/powered)
"bc" = (/obj/structure/table,/obj/item/weapon/paper{desc = "That's it, the food will end soon, the crew was killed by carps, we lost in our way somehow, i cant fix the computer, at least i can end this quick"; pixel_y = 3},/turf/open/floor/plasteel/shuttle/white,/area/ruin/powered)
"bd" = (/obj/structure/closet/crate/secure/weapon,/turf/open/floor/plasteel/shuttle/white,/area/ruin/powered)
"be" = (/obj/machinery/door/airlock/shuttle,/turf/open/space,/area/ruin/powered)
"bf" = (/obj/structure/chair{dir = 8},/mob/living/simple_animal/hostile/nanotrasen/ranged,/turf/open/floor/plasteel/shuttle/white,/area/ruin/powered)
"bg" = (/turf/open/space,/turf/closed/wall/shuttle{icon_state = "swall_f9"; dir = 2},/area/ruin/powered)

(1,1,1) = {"
aaaaaaaaaaaaaaabaaaaaaaaaaaaaaaaaaaaaaaaaaaaaaaaaaaaaaaa
aaaaaaaaaaaaacadadacaaaaaaaaaaaaaaaaaaaaaaaaaaaaaaaaaaaa
aaaaaaaaaaaeacafafacagaaaaaaaaaaaaaaaaaaaaaaaaaaaaaaaaaa
aaaaaaaaaeacacadadacacacacacacacacacacacacacagaaaaaaaaaa
aaaaaaacacacahaiaiafafajajajajajacakalamanacacaaaaaaaaaa
aaaaaaaaaoapaqafafafafafafafafafafafafafafarasaaaaaaaaaa
aaaaaaaaaoapaqafafafafafafafafafafafafafatakasaaaaaaaaaa
aaaaaaaaaoapauafafafafafafafafafafafafafafavasaaaaaaaaaa
aaaaaaaaaoapawafafafaiaxafafayafafafafafafavasaaaaaaaaaa
aaaaaaacacacazafafafaAaAaBaCaDaBaEakaFamanacacaaaaaaaaaa
aaaaaaaaaGacacadadacacacacacacacacacacacacacaHaaaaaaaaaa
aaaaaaaaaaaGacafaxacaHaaaaaaaaaaaaaaaaaaaaaaaaaaaaaaaaaa
aaaaaaaaaaaaacadadacaaaaaaaaaaaaaaaaaaaaaaaaaaaaaaaaaaaa
aIaIaIaIaIaJaJaKaKaIaIaIaIaIaLaaaaaaaaaaaaaaaaaaaaaaaaaa
aoaMaNaOaOaOaOaOaOaPaKaQaOaIaIaaaaaaaaaaaaaaaaaaaaaaaaaa
aoaMaRaOaOaOaPaOaOaSaKaTaOaUaVaaaaaaaaaaaaaaaaaaaaaaaaaa
aoaMaWaOaPaOaOaOaOaOaXaOaOaUaVaaaaaaaaaaaaaaaaaaaaaaaaaa
aoaMaYaOaOaOaOaOaOaOaIaOaZbaaVaaaaaaaaaaaaaaaaaaaaaaaaaa
aoaMbbaOaOaOaOaPaOaOaIaOaObcaVaaaaaaaaaaaaaaaaaaaaaaaaaa
aoaMbbbdaPaOaOaOaOaObeaOaOaCaVaaaaaaaaaaaaaaaaaaaaaaaaaa
aoaMbbbdbdaOaOaOaObfaIaOaOaIaIaaaaaaaaaaaaaaaaaaaaaaaaaa
aIaIaIaIaIaIaJaJaJaJaIaIaIaIbgaaaaaaaaaaaaaaaaaaaaaaaaaa
"}
