"a" = (/turf/open/space,/area/space)
"c" = (/turf/closed/mineral/random/high_chance,/area/ruin/unpowered)
"d" = (/turf/open/floor/plating/asteroid/airless,/area/ruin/unpowered)
"o" = (/obj/docking_port/stationary{dir = 2; dwidth = 11; height = 22; id = "whiteship_mining1"; name = "Small Asteroid"; width = 35},/turf/open/space,/area/space)

(1,1,1) = {"
aaaaaaaaaaaaaaaaaaaaaaaaaaaaaaaaaaaaaaaa
aaaaaaaaaaaaaaaccccccccaaaaaaaaaaaaaaaaa
aaaaaaaaaaccccccccccccccccccaaaaaaaaaaaa
aaaaaaaaccccccccccdddccccccccaaaaaaaaaaa
aaaaaccccccccccdddddddddcccccaaaaaaaaaaa
aaaaaccccccccccddddddddddccccaaaaaaaaaaa
aaacccccccccddddddaaaaaddddccaaaaaaaaaaa
aaaccccccccdddaaaaaaaaaadddcccaaaaaaaaaa
aaaccccccdddaaaaaacccaaadddcccaaaaaaaaaa
aaaccccccddaaaaaaacccaaaaaaaccaaaaaaaaaa
aaaaccccdddaaaaaaaaccaaaaaaaccaaaaaaacaa
aaaaacccddaaaaaaaaaaaaaaaaaaccaaaaaaccaa
aaaaacccddaaaaacaaaaaaaaaaaccaaaaaacccca
aaaaacccddddaaaaaaaaaaaaaaaccaaaaaacccca
aaaaaacccdddaaaaaaaaaaaaaaaaaaaaaaacccca
aaaaaacccdddaaaaaaaccaacaaaaaaaaadddccca
aaaaaaccccccaaaaaccccaaaaaaaaaadddddccaa
aaaaaaaaaaaaaaaaaccccaaaaaaaaaadddddccaa
aaaaaaaaaaaaaaaaacccaaaaaaaadddddddcccaa
aaaaaaaaaaaaaaaaaaccaaaaaaaaddddcddcccca
aaaaaaaaaaaaaaaaaaaaaaaaaaaaddddcddcccca
aaaaaaaaaaaaaaaaaaaaaaaaaaaacccccdddccca
aaaaaaaaaaaaacdddddcccaaaaacccccccdddcca
aaaaaaaaacdddddddddddddaaaaaccccccdddcca
aaaaaaacddddddccccccdddaaaaaaaccccddccaa
aaaaaacddddcccccccccddddcaaaaaccccccccaa
aaaaaacdcccccccccccccccdcaaaaaccccccccaa
aaaaddddcccccccccccccccdddaaaaacccccaaaa
aaaaddddccccdddcccdddccdddaaaaaaacccaaaa
aaaddddcccccdddcdddddccdddaaaaaaaaaaaaaa
aaaddddcccccdcccddddddddddaaaaaaaaaaaaaa
accdddcccccdddddddccddddddaaaaaaaaaaaaaa
accccccccccdddddddccccccccaaaaaaaaaaaaaa
accccccccccddddddcccccccccaaaaaaaaaaaaaa
acccccccccccccccccccccccccaaaaaaaaaccaaa
aacccccccccccccccccccccccaaaaaaaaacccaaa
aacccccccccccccccccccccccaaaaaaaaccccaaa
aaaccccccccacccccccccccccaaaaaaaacccaaaa
aaacccccaaaaaaaacccccccaaaaaaaaaaaaaaaaa
aaaaaaaaaaaaaaaaaaaaaaaaaaaaaaaaaaaaaaaa
aaaaaaaaaaaaaaaaaaaaoaaaaaaaaaaaaaaaaaaa
aaaaaaaaaaaaaaaaaaaaaaaaaaaaaaaaaaaaaaaa
aaaaaaaaaaaaaaaaaaaaaaaaaaaaaaaaaaaaaaaa
aaaaaaaaaaaaaaaaaaaaaaaaaaaaaaaaaaaaaaaa
aaaaaaaaaaaaaaaaaaaaaaaaaaaaaaaaaaaaaaaa
aaaaaaaaaaaaaaaaaaaaaaaaaaaaaaaaaaaaaaaa
aaaaaaaaaaaaaaaaaaaaaaaaaaaaaaaaaaaaaaaa
aaaaaaaaaaaaaaaaaaaaaaaaaaaaaaaaaaaaaaaa
aaaaaaaaaaaaaaaaaaaaaaaaaaaaaaaaaaaaaaaa
aaaaaaaaaaaaaaaaaaaaaaaaaaaaaaaaaaaaaaaa
aaaaaaaaaaaaaaaaaaaaaaaaaaaaaaaaaaaaaaaa
aaaaaaaaaaaaaaaaaaaaaaaaaaaaaaaaaaaaaaaa
aaaaaaaaaaaaaaaaaaaaaaaaaaaaaaaaaaaaaaaa
aaaaaaaaaaaaaaaaaaaaaaaaaaaaaaaaaaaaaaaa
aaaaaaaaaaaaaaaaaaaaaaaaaaaaaaaaaaaaaaaa
aaaaaaaaaaaaaaaaaaaaaaaaaaaaaaaaaaaaaaaa
aaaaaaaaaaaaaaaaaaaaaaaaaaaaaaaaaaaaaaaa
aaaaaaaaaaaaaaaaaaaaaaaaaaaaaaaaaaaaaaaa
aaaaaaaaaaaaaaaaaaaaaaaaaaaaaaaaaaaaaaaa
aaaaaaaaaaaaaaaaaaaaaaaaaaaaaaaaaaaaaaaa
aaaaaaaaaaaaaaaaaaaaaaaaaaaaaaaaaaaaaaaa
aaaaaaaaaaaaaaaaaaaaaaaaaaaaaaaaaaaaaaaa
"}

