"a" = (/turf/open/space,/area/space)
"b" = (/obj/docking_port/stationary{dwidth = 5; height = 15; id = "freebus_asteroid5"; name = "Asteroid Signal: UNKNOWN"; width = 15},/turf/open/space,/area/space)
"c" = (/turf/closed/mineral/random/high_chance,/area/ruin/unpowered)
"d" = (/turf/open/floor/plating/asteroid/airless,/area/ruin/unpowered)
"e" = (/turf/closed/mineral/random/high_chance,/area/space)
"f" = (/obj/docking_port/stationary{dwidth = 3; height = 5; id = "mining_asteroid5"; name = "Asteroid Signal: UNKNOWN"; width = 8},/turf/open/space,/area/space)
"g" = (/obj/docking_port/stationary{dir = 2; dwidth = 11; height = 22; id = "whiteship_mining1"; name = "Small Asteroid"; width = 35},/turf/open/space,/area/space)

(1,1,1) = {"
aaaaaaabaaaaaaaaaaaaaaaaaaaaaaaaaaaaaaaa
aaaaaaaaaaaaaaaccccccccaaaaaaaaaaaaaaaaa
aaaaaaaaaaccccccccccccccccccaaaaaaaaaaaa
aaaaaaaacccccccccccccccccccccaaaaaaaaaaa
aaaaaccccccccccccccccccccccccaaaaaaaaaaa
aaaaaccccccccccddddddddccccccaaaaaaaaaaa
aaaccccccccccdddddaaaaadcccccaaaaaaaaaaa
aaaccccccccdddaaaaaaaaaadcccccaaaaaaaaaa
aaaccccccccdaaaaaacccaaadcccccaaaaaaaaaa
aaacccccccdaaaaaaacccaaaaaaaccaaaaaaaaaa
aaaaccccccdaaaaaaaaccaaaaaaaccaaaaaaacaa
aaaaaccccdaaaaaaaaaaaaaaaaaaccaaaaaaccaa
aaaaaccccdaaaaacaaaaaaaaaaaccaaaaaacccca
aaaaacccccddaaaaaaaaaaaaaaaccaaaaaacccca
aaaaaacccccceaaaaaaaaaaaaaaaaaaaaaacccca
aaaaaacccccceeaaaaaccaacaaaaaaaaadccccca
aaaaaacccccceeaaaccccaaaaaaaaaaddcccccaa
aaaaaaaaeeeeeeeaaccccaaaaaaaaaadccccccaa
aaaaaaaaaaeeeeaaacccaaaaaaaaddccccccccaa
aaaaaaaaaaaaeeeaaaccaaaaaaaaccccccccccca
aaaaaaaaaaaaaaaaaaaaaaaaaaaaccccccccccca
aaaaaaaaaaaaaaaaaaaaaaaaaaaaccccccccccca
aaaaaaaaaaaaacdddddcccaaaaacccccccccccca
aaaaaaaaaccccdddddcddddaaaaaccccccccccca
aaaaaaacccccccccccccdddaaaaaaaccccccccaa
aaaaaacccccccccccccccdddcaaaaaccccccccaa
aaaaaacccccccccccccccccdcaaaaaccccccccaa
aaaaddcccccccccccccccccdddaaaaacccccaaaa
aaaadccccccccccccccccccccdaaaaaaacccaaaa
aaaddcccccccccccdccccccccdaaaaaaaaaaaaaa
aaadccccccccccccddccccccccaaaaaaaaaaaaaa
acccccccccccccccccccccccccaaaaaaaaaaaaaa
acccccccccccccccccccccccccaaaaaaaaaaaaaa
acccccccccccccccccccccccccaaaaaafaaaaaaa
acccccccccccccccccccccccccaaaaaaaaaccaaa
aacccccccccccccccccccccccaaaaaaaaacccaaa
aacccccccccccccccccccccccaaaaaaaaccccaaa
aaaccccccccacccccccccccccaaaaaaaacccaaaa
aaacccccaaaaaaaacccccccaaaaaaaaaaaaaaaaa
aaaaaaaaaaaaaaaaaaaaaaaaaaaaaaaaaaaaaaaa
aaaaaaaaaaaaaaaaaaaagaaaaaaaaaaaaaaaaaaa
aaaaaaaaaaaaaaaaaaaaaaaaaaaaaaaaaaaaaaaa
aaaaaaaaaaaaaaaaaaaaaaaaaaaaaaaaaaaaaaaa
aaaaaaaaaaaaaaaaaaaaaaaaaaaaaaaaaaaaaaaa
aaaaaaaaaaaaaaaaaaaaaaaaaaaaaaaaaaaaaaaa
aaaaaaaaaaaaaaaaaaaaaaaaaaaaaaaaaaaaaaaa
aaaaaaaaaaaaaaaaaaaaaaaaaaaaaaaaaaaaaaaa
aaaaaaaaaaaaaaaaaaaaaaaaaaaaaaaaaaaaaaaa
aaaaaaaaaaaaaaaaaaaaaaaaaaaaaaaaaaaaaaaa
aaaaaaaaaaaaaaaaaaaaaaaaaaaaaaaaaaaaaaaa
aaaaaaaaaaaaaaaaaaaaaaaaaaaaaaaaaaaaaaaa
aaaaaaaaaaaaaaaaaaaaaaaaaaaaaaaaaaaaaaaa
aaaaaaaaaaaaaaaaaaaaaaaaaaaaaaaaaaaaaaaa
aaaaaaaaaaaaaaaaaaaaaaaaaaaaaaaaaaaaaaaa
aaaaaaaaaaaaaaaaaaaaaaaaaaaaaaaaaaaaaaaa
aaaaaaaaaaaaaaaaaaaaaaaaaaaaaaaaaaaaaaaa
aaaaaaaaaaaaaaaaaaaaaaaaaaaaaaaaaaaaaaaa
aaaaaaaaaaaaaaaaaaaaaaaaaaaaaaaaaaaaaaaa
aaaaaaaaaaaaaaaaaaaaaaaaaaaaaaaaaaaaaaaa
aaaaaaaaaaaaaaaaaaaaaaaaaaaaaaaaaaaaaaaa
aaaaaaaaaaaaaaaaaaaaaaaaaaaaaaaaaaaaaaaa
aaaaaaaaaaaaaaaaaaaaaaaaaaaaaaaaaaaaaaaa
"}
