"a" = (/turf/open/space,/area/space)
"b" = (/obj/docking_port/stationary{dwidth = 3; height = 5; id = "mining_asteroid13"; name = "Signal Readings: UNKNOWN"; width = 8},/turf/open/space,/area/space)
"c" = (/turf/closed/mineral/random/high_chance,/area/ruin/unpowered/no_grav)
"d" = (/turf/closed/mineral/random,/area/ruin/unpowered/no_grav)

(1,1,1) = {"
aaaaaaaaabaaaaaaaaaa
aaacccccaaaaaaccccaa
accccccccaaccccddcca
accccccccaccddddddcc
acccccccaacddddddddc
accccccaaccddddddddc
acccccaaccdddddddddc
ccccccaccdddddddddcc
cccaaacccddddddddccc
aaaacccdddddddddcccc
aaaccccdddddddddcccc
aaaccccddddddddcccca
aaaacccdddddddcccaaa
acaaacccdddcccaaaaaa
accaaaccccccaaacccca
cccccaacccaaaaccccca
ccccccaaaaaaccccccca
ccccccaaaaaaacccccca
accccaaaaaaaaaccccca
aaccaaaaaaaaaaaaccaa
"}
