"a" = (/turf/open/space,/area/space)
"b" = (/turf/closed/wall/r_wall,/area/ruin/unpowered/no_grav)
"c" = (/turf/open/floor/plating,/obj/structure/girder,/obj/item/stack/sheet/plasteel,/turf/open/floor/plating/airless{broken = 1; icon_state = "platingdmg2"},/area/ruin/unpowered/no_grav)
"d" = (/obj/structure/lattice,/turf/open/space,/area/space)
"e" = (/obj/structure/filingcabinet,/turf/open/floor/plasteel/airless/black,/area/ruin/unpowered/no_grav)
"f" = (/turf/open/floor/plasteel/airless/black,/area/ruin/unpowered/no_grav)
"g" = (/obj/machinery/airalarm{pixel_y = 20},/turf/open/floor/plasteel/airless/black,/area/ruin/unpowered/no_grav)
"h" = (/turf/open/space,/turf/open/floor/plating/airless{broken = 1; icon_state = "platingdmg2"},/area/ruin/unpowered/no_grav)
"i" = (/obj/machinery/light_construct{dir = 8},/turf/open/floor/plasteel/airless/black,/area/ruin/unpowered/no_grav)
"j" = (/turf/open/floor/plasteel/airless/circuit/gcircuit,/area/ruin/unpowered/no_grav)
"k" = (/obj/machinery/power/apc{pixel_x = -23},/obj/structure/cable{icon_state = "0-4"; d2 = 4},/turf/open/floor/plasteel/airless/black,/area/ruin/unpowered/no_grav)
"l" = (/obj/structure/cable{d1 = 2; d2 = 8; icon_state = "2-8"},/turf/open/floor/plasteel/airless/circuit/gcircuit,/area/ruin/unpowered/no_grav)
"m" = (/obj/machinery/nuclearbomb/selfdestruct,/turf/open/floor/plasteel/airless/circuit/gcircuit,/area/ruin/unpowered/no_grav)
"n" = (/obj/structure/closet/crate{icon_state = "crateopen"; opened = 1},/turf/open/floor/plasteel/airless/black,/area/ruin/unpowered/no_grav)
"o" = (/obj/structure/cable{d1 = 1; d2 = 2; icon_state = "1-2"},/turf/open/floor/plasteel/airless/circuit/gcircuit,/area/ruin/unpowered/no_grav)
"p" = (/obj/structure/closet/crate,/obj/item/stack/sheet/mineral/gold,/obj/item/stack/sheet/mineral/gold,/obj/item/stack/sheet/mineral/gold,/obj/item/stack/sheet/mineral/gold,/obj/item/stack/sheet/mineral/gold,/turf/open/floor/plasteel/airless/black,/area/ruin/unpowered/no_grav)
"q" = (/obj/machinery/light_construct,/obj/structure/cable{d1 = 1; d2 = 4; icon_state = "1-4"; tag = ""},/obj/machinery/atmospherics/components/unary/vent_scrubber,/turf/open/floor/plasteel/airless/black,/area/ruin/unpowered/no_grav)
"r" = (/obj/structure/cable{d1 = 2; d2 = 8; icon_state = "2-8"},/turf/open/floor/plasteel/airless/black,/area/ruin/unpowered/no_grav)
"s" = (/obj/machinery/light_construct,/obj/machinery/atmospherics/components/unary/vent_pump,/turf/open/floor/plasteel/airless/black,/area/ruin/unpowered/no_grav)
"t" = (/obj/structure/closet/crate,/obj/item/weapon/coin/clown,/obj/item/weapon/coin/silver,/obj/item/weapon/coin/silver,/obj/item/weapon/coin/clown,/obj/item/weapon/coin/gold,/obj/item/weapon/coin/gold,/turf/open/floor/plasteel/airless/black,/area/ruin/unpowered/no_grav)
"u" = (/obj/machinery/atmospherics/pipe/simple/scrubbers,/turf/closed/wall/r_wall,/area/ruin/unpowered/no_grav)
"v" = (/obj/structure/cable{d1 = 1; d2 = 2; icon_state = "1-2"},/turf/open/floor/plasteel/airless/black,/area/ruin/unpowered/no_grav)
"w" = (/obj/machinery/atmospherics/pipe/simple/supply,/turf/closed/wall/r_wall,/area/ruin/unpowered/no_grav)
"x" = (/obj/structure/door_assembly/door_assembly_highsecurity,/obj/structure/cable{d1 = 1; d2 = 2; icon_state = "1-2"},/turf/open/floor/plasteel/airless/black,/area/ruin/unpowered/no_grav)
"y" = (/obj/machinery/atmospherics/pipe/simple/scrubbers,/turf/closed/wall,/area/ruin/unpowered/no_grav)
"z" = (/obj/structure/cable{d1 = 1; d2 = 2; icon_state = "1-2"},/turf/open/floor/plasteel/airless,/area/ruin/unpowered/no_grav)
"A" = (/obj/machinery/atmospherics/pipe/simple/supply,/turf/closed/wall,/area/ruin/unpowered/no_grav)
"B" = (/turf/open/floor/plating,/turf/open/floor/plating/airless{broken = 1; icon_state = "platingdmg2"},/area/ruin/unpowered/no_grav)
"C" = (/turf/closed/wall,/area/ruin/unpowered/no_grav)
"D" = (/obj/structure/door_assembly/door_assembly_highsecurity,/turf/open/floor/plasteel/airless,/area/ruin/unpowered/no_grav)

(1,1,1) = {"
aaaaaaaaaaaaaaa
aaaaaaaaaaaaaaa
aaaabbbbcddaaaa
aaaabefghhdaaaa
aaaabijjhhcaaaa
aaaabklmjnbaaaa
aaaabfojjfbaaaa
aaaabpqrstbaaaa
aaaabbuvwbbaaaa
aaaaaauxwaaaaaa
aaaaaayzAaaaaaa
aaaaaaazAaaaaaa
aaaaaadBaaaaaaa
aaaaaayBdaaaaaa
aaaaaayzAaaaaaa
aaaaaayzAaaaaaa
aaaaaaCDCaaaaaa
aaaaaaCBBaaaaaa
aaaaaaBddaaaaaa
aaaaaaddaaaaaaa
"}
