"a" = (/turf/open/space,/area/space)
"b" = (/turf/closed/mineral/random/low_chance,/area/ruin/unpowered)
"d" = (/turf/open/floor/plating/asteroid/airless,/area/ruin/unpowered)
"n" = (/mob/living/simple_animal/hostile/asteroid/goliath,/turf/open/floor/plating/asteroid/airless,/area/ruin/unpowered)
"s" = (/mob/living/simple_animal/hostile/asteroid/basilisk,/turf/open/floor/plating/asteroid/airless,/area/ruin/unpowered)
"w" = (/obj/docking_port/stationary{dir = 2; dwidth = 11; height = 22; id = "whiteship_mining"; name = "Free Miner Asteroid"; width = 35},/turf/open/space,/area/space)
"D" = (/turf/closed/mineral/random/high_chance,/area/ruin/unpowered)
"I" = (/mob/living/simple_animal/hostile/asteroid/hivelord,/turf/open/floor/plating/asteroid/airless,/area/ruin/unpowered)
"K" = (/mob/living/simple_animal/hostile/asteroid/goldgrub,/turf/open/floor/plating/asteroid/airless,/area/ruin/unpowered)
"R" = (/turf/open/space,/area/ruin/unpowered)

(1,1,1) = {"
aaaaaaaaaaaaaaaaaaaaaaaaaaaaaaaaaaaaaaaaaaaaaaaaaaaaaaaaaaaaaaaaaaaaaaaaaaaaaaaa
aaaaaaaaaaaaaaaaaaaaaaaaaaaaaaaaaaaaaaaaaaaaaaaaaaaaaaaaaaaaaaaaaaaaaaaaaaaaaaaa
aaaaaaaaaaaaaaaaaaaaaaaaaaaaaaaaaaaaaaaaaaaaaaaaaaaaaaaaaaaaaaaaaaaaaaaaaaaaaaaa
aaaaaaaaaaaaaaaaaaaaaaaaaaaaaaaaaaaaaaaaaaaaaaaaaaaaaaaaaaaaaaaaaaaaaaaaaaaaaaaa
aaaaaaaaaaaaaaaaaaaaaaaaaaaaaaaaaaaaaaaaaaaaaaaaaaaaaaaaaaaaaaaaaaaaaaaaaaaaaaaa
aaaaaaaaaaaaaaaaaaaaaaaaaaaaaaaaaaaaaaaaaaaaaaaaaaaaaaaaaaaaaaaaaaaaaaaaaaaaaaaa
aaaaaaaaaaaaaaaaaaaaaaaaaaaaaaaaaaaaaaaaaaaaaaaaaaaaaaaaaaaaaaaaaaaaaaaaaaaaaaaa
aaaaaaaaaaaaaaaaaaaaaaaaaaaaaaaaaaaaaaaaaaaaaaaaaaaaaaaaaaaaaaaaaaaaaaaaaaaaaaaa
aaaaaaaaaaaaaaaaaaaaaaaaaaaaaaaaaaaaaaaaaaaaaaaaaaaaaaadddaaaaaaaaaaaaaaaaaaaaaa
aaaaaaaaaaaaaaaaaaaaaaaaaaaaaaaaaaaaaaaaaaaaaaaaaadadabbbbbbaaaaaaaaaaaaaaaaaaaa
aaaaaaaaaaaaaaaaaaaaaaaaaaaddadddRaaadddaaaaaddadddddbbbbbbbaaaaaaaaaaaaaaaaaaaa
aaaaaaaaaaaaaaaaaaaaaaaabbbddbbbbbbbbbbbbbddbbbbbbbbbbbbbbbbbaaaaaaaaaaaaaaaaaaa
aaaaaaaaaaaaaaaaaaaaababbbbbbbbbbbbbbbbbbddbbbbbbbbbbbbbbbbbbbaaaaaaaaaaaaaaaaaa
aaaaaaaaaaaaaaaaaaaabbbbbbbbbbbbbbbbbbbbbddbbbbbbbbbbbbbbbbbbbbbaaaaaaaaaaaaaaaa
aaaaaaaaaaaaaaaaaabbbbbbbbbbbbbbbbbbbbbbddbbbbbbbbbbbbbbbbbbbbbbbaaaaaaaaaaaaaaa
aaaaaaaaaaaaaaaabbbbbbbbbbbbbbbbbbbbbbbbddbbbbbbbbbbbbbbbbbbbbbbbbaaaaaaaaaaaaaa
aaaaaaaaaaaaabbbbbbbbbbbbbbbbbbbbbbbbbbddbbbbbbbbbbbbbbbbbbbbbbbbbdaaaaaaaaaaaaa
aaaaaaaaaaaaabbbbbbbbbbbbbbbbbbbbbbbbbbddbbbbbbbbbbbbbbbbbbbbbbbbbdaaaaaaaaaaaaa
aaaaaaaaaaaabbbbbbbbbbbbbbbbbbbbbbbbbbddbbbbbbbbbbbbbbbbbbbbbbbbbbdaaaaaaaaaaaaa
aaaaaaaaaabbbbbbbbbbbbbbbbbbbbbbbbbbbdddbbbbbbbbbbbbbbbbbbbbbbbbbbdaaaaaaaaaaaaa
aaaaaaaaabbbbbbbbbbbbbbbbbbbbbbbbbbbdddbbbbbbbbbbbbbbbDDbbbbbbbbbddaaaaaaaaaaaaa
aaaaaaaabbbbbbbbbbbbbbbbbbbDbbbbbbbbddbbbbbbbbbbbbbbbbDDbbbbbbbbbddaaaaaaaaaaaaa
aaaaaaabbbbbbbDDDDDbbbbbbbbDDbbbbbbbddbbbbbbbbbbbbbbbbbbbbbbbbbbbddaaaaaaaaaaaaa
aaaaaaabbbbbbbDdddDbbbbbbbbbDbbbbbbbbdddbbbbbbbbbbbbbbbbbbbbbbbbbddaaaaaaaaaaaaa
aaaaaaabbbbbbbDdddDbbbbbbbbbbbbbbbbbbbdddbbbbbbbbbbbbbbbbbbbbbbbbddaaaaaaaaaaaaa
aaaaaaabbbbbbbDdIdDbbbbbbbbbbbbbbbbbbbbdddbbbbbbbbbbbbbbbbbbbbbbbddaaaaaaaaaaaaa
aaaaaaabbbbbbbDDDDDbbbbbbbbbbbbbbbbbbbbbdddbbbbbbDDDbbbbbbbbbbbbbbddaaaaaaaaaaaa
aaaaaaabbbbbbbbbbbbbbbbbbbbbbbbbbbbbbbbbbdddbbbbbDDDbbbbbbbbbbbbbbddaaaaaaaaaaaa
aaaaaaaabbbbbbbbbbbbbbbbbbbbbbbbbbbbbbbbbbdddbbbbbbbbbbbbbbbbbbbbbddaaaaaaaaaaaa
aaaaaaabbbbbbbbbbbbbbddbbbbbbbbbbbbbbbbbbbbdddbbbbbbbbbbbbbbbbbbbbbddaaaaaaaaaaa
aaaaaaabbbbbbbbbbbbbbdddbbbbbbbbbbbbbbbbbbbbdddbbbbbbbbbbbbbbbbbbbbddaaaaaaaaaaa
aaaaaaabbbbbbbbbbbbbbbdddbbbbbbbbbbDDDDbbbbbbdddbbbbbbbbbbbbbbbbbbbddaaaaaaaaaaa
aaaaaaaabbbbbbbbbbbbbbbdddbbbbbbbbDDDDDDbbbbbbbdbbbbbbbbbdbbbbbbbbbddaaaaaaaaaaa
aaaaaaaabbbbbbbbbbbbbbbbddbbbbbbbbDDDDDDbbbbbbbddbbbbbbbKdbbbbbbbbbdaaaaaaaaaaaa
aaaaaaaaabbbbbbbbbbbbbbbdddbbbbbbbDDDDDDbbbbbbbddbbbbbbdddbbbbbbbbbdaaaaaaaaaaaa
aaaaaaaaabbbbbbbbbbbbbbbbddbbbbbbbbDDDDDbbbbbbbddbbbbbdddbbbbbbbbbbdaaaaaaaaaaaa
aaaaaaaaaabbbbbDDDDbbbbbbddbbbbbbbbbbDDbbbbbbbbdddbbbdddbbbbbbbbbbbdaaaaaaaaaaaa
aaaaaaaaaabbbbbDddDbbbbbbbdddbbbbbbbbbbbbbbbbbbdddbddddbbbbbbbbbbbbdaaaaaaaaaaaa
aaaaaaaaaaabbbbDdsDbbbbbbbbbdbbbbbbbbbbbbbbbbbbdddddbbbbbbbbbbbbbbbbaaaaaaaaaaaa
aaaaaaaaaaabbbbDddDbbbbbbbbbddbbbbbbbbbbbbbbbbbdddbbbbbbbbbbbbbbbbbbaaaaaaaaaaaa
aaaaaaaaaaabbbbDDdDDbbbbbbbbbddbbbbbbbbbbbbbbbbdddbbbbbbbbbbbbbbbbbbaaaaaaaaaaaa
aaaaaaaaaaabbbbbDddDbbbbbbbbbbddbbbbbbbbbbbbbbbddbbbbbbbbDbbbbbbbbbbaaaaaaaaaaaa
aaaaaaaaaaabbbbbDddbbbbbbbbbbbbddbbbbbbbbbbbbbbddbbbbbbbbbbbbbbbbbbbaaaaaaaaaaaa
aaaaaaaaaaabbbbbDddbbbbbbbbbbbbbddbbbbbbbbbbbbdddbbbbbbbbbbbbbbbbbbbaaaaaaaaaaaa
aaaaaaaaaaaabbbbbbddbbbbbbbbbbbbbddbbbbbbbbbbbdddbbbbbbbbbbbbbbbbbbbaaaaaaaaaaaa
aaaaaaaaaaabbbbbbbddbbbbbbbbbbbbbbddbbbddbbbbdddbbbbbbbbbbbbbbbbbbbbaaaaaaaaaaaa
aaaaaaaaaaabbbbbbbdddbbbbbbbbbbbbbbddbbbdbbbbddbbbbbbbbbbbbbbbbbbbbdaaaaaaaaaaaa
aaaaaaaaaaabbbbbbbbdddbbbbbbbbbbbbbbddbbddbdddbbbbbbbbbbbbbbbbbbbbbdaaaaaaaaaaaa
aaaaaaaaaaabbbbbbbbdddbbbbbbbbbbbbbbbddbddbddbbbbbbbbbbbbbbbbbbbbddaaaaaaaaaaaaa
aaaaaaaaaaaabbbbbbbbbbbbbbbbbbbbbbbbbbddddddbbbbbbbbbDDDbbbbbbbbaaaaaaaaaaaaaaaa
aaaaaaaaaaaabbbbbbbbbbbbbbbbbbbbbbbbbbbbdddbbbbbbbbbbDDDbbbbbbbaaaaaaaaaaaaaaaaa
aaaaaaaaaaaabbbbbbbbbbbbbbbbbbbbbbbbbbbdddbbbbbbbbbbbDDDbbbbbbaaaaaaaaaaaaaaaaaa
aaaaaaaaaaaabbbbbbbbbbbbDDDDDbbbbbbbbbbdddbbbbbbbbbbbbbbbbbbbaaaaaaaaaaaaaaaaaaa
aaaaaaaaaaaabbbbbbbbbbDDDdddDbbbbbbbbbbdddbbbbbbbbbbbbbbbbbbbaaaaaaaaaaaaaaaaaaa
aaaaaaaaaaaabbbbbbbbbbDdddddDbbbbbbbbbbdddbbbbDbbbbbbbbbbbbbbaaaaaaaaaaaaaaaaaaa
aaaaaaaaaaaabbbbbbbbbbDddnddDbbbbbbbbbbdddbbbbDbbbbbbbbbbbbbdaaaaaaaaaaaaaaaaaaa
aaaaaaaaaaaaabbbbbbbbbDddDDDDbbbbbbbbbbdddbbbbbbbbbbbbbbbbbdaaaaaaaaaaaaaaaaaaaa
aaaaaaaaaaaaaaabbbbbbbDDdDbbbbbbbbbbbbbdddbbbbbbbbbbbbbbbbdaaaaaaaaaaaaaaaaaaaaa
aaaaaaaaaaaaaaaabbbbbbbDDDbbbbbbbbbbbbbddddbbbbbbbbbbbbbbbdaaaaaaaaaaaaaaaaaaaaa
aaaaaaaaaaaaaaaaabbbbbbbbbbbbbbbbbbbbbbddddbbbbbbbbbbbbbbbaaaaaaaaaaaaaaaaaaaaaa
aaaaaaaaaaaaaaaaadbbbbbbbbbbbbbbbbbbbbdddddbbbbbbbbbbbbbdaaaaaaaaaaaaaaaaaaaaaaa
aaaaaaaaaaaaaaaaaaaddbbbbbbbbbbbbbbbbddddddbbbbbdddddddddaaaaaaaaaaaaaaaaaaaaaaa
aaaaaaaaaaaaaaaaaaadddddbbbbbbbbbbddddddddddddddddddddddaaaaaaaaaaaaaaaaaaaaaaaa
aaaaaaaaaaaaaaaaaaaadddddddbbbbbdddddddaaadddaadddddddddaaaaaaaaaaaaaaaaaaaaaaaa
aaaaaaaaaaaaaaaaaaaaadddddddddddddddddaaaaaaaaaaaaddddaaaaaaaaaaaaaaaaaaaaaaaaaa
aaaaaaaaaaaaaaaaaaaaaadddddddddaaaaaaaaaaaaaaaaaaaaaaaaaaaaaaaaaaaaaaaaaaaaaaaaa
aaaaaaaaaaaaaaaaaaaaaaaaaaaaaaaaaaaaaaaaaaaaaaaaaaaaaaaaaaaaaaaaaaaaaaaaaaaaaaaa
aaaaaaaaaaaaaaaaaaaaaaaaaaaaaaaaaaaaaaaaaaawaaaaaaaaaaaaaaaaaaaaaaaaaaaaaaaaaaaa
aaaaaaaaaaaaaaaaaaaaaaaaaaaaaaaaaaaaaaaaaaaaaaaaaaaaaaaaaaaaaaaaaaaaaaaaaaaaaaaa
aaaaaaaaaaaaaaaaaaaaaaaaaaaaaaaaaaaaaaaaaaaaaaaaaaaaaaaaaaaaaaaaaaaaaaaaaaaaaaaa
aaaaaaaaaaaaaaaaaaaaaaaaaaaaaaaaaaaaaaaaaaaaaaaaaaaaaaaaaaaaaaaaaaaaaaaaaaaaaaaa
aaaaaaaaaaaaaaaaaaaaaaaaaaaaaaaaaaaaaaaaaaaaaaaaaaaaaaaaaaaaaaaaaaaaaaaaaaaaaaaa
aaaaaaaaaaaaaaaaaaaaaaaaaaaaaaaaaaaaaaaaaaaaaaaaaaaaaaaaaaaaaaaaaaaaaaaaaaaaaaaa
aaaaaaaaaaaaaaaaaaaaaaaaaaaaaaaaaaaaaaaaaaaaaaaaaaaaaaaaaaaaaaaaaaaaaaaaaaaaaaaa
aaaaaaaaaaaaaaaaaaaaaaaaaaaaaaaaaaaaaaaaaaaaaaaaaaaaaaaaaaaaaaaaaaaaaaaaaaaaaaaa
aaaaaaaaaaaaaaaaaaaaaaaaaaaaaaaaaaaaaaaaaaaaaaaaaaaaaaaaaaaaaaaaaaaaaaaaaaaaaaaa
aaaaaaaaaaaaaaaaaaaaaaaaaaaaaaaaaaaaaaaaaaaaaaaaaaaaaaaaaaaaaaaaaaaaaaaaaaaaaaaa
aaaaaaaaaaaaaaaaaaaaaaaaaaaaaaaaaaaaaaaaaaaaaaaaaaaaaaaaaaaaaaaaaaaaaaaaaaaaaaaa
aaaaaaaaaaaaaaaaaaaaaaaaaaaaaaaaaaaaaaaaaaaaaaaaaaaaaaaaaaaaaaaaaaaaaaaaaaaaaaaa
aaaaaaaaaaaaaaaaaaaaaaaaaaaaaaaaaaaaaaaaaaaaaaaaaaaaaaaaaaaaaaaaaaaaaaaaaaaaaaaa
"}

