"a" = (/turf/open/space,/area/space)
"b" = (/obj/docking_port/stationary{dwidth = 5;height = 15;id = "freebus_asteroid0";name = "Unknown Asteroid Signal";width = 15},/turf/open/space,/area/space)
"c" = (/turf/open/floor/plating/asteroid/airless,/area/ruin/unpowered)
"d" = (/turf/closed/mineral/random/low_chance,/area/ruin/unpowered)
"e" = (/turf/closed/mineral/random/high_chance,/area/ruin/unpowered)
"f" = (/mob/living/simple_animal/hostile/asteroid/hivelord,/turf/open/floor/plating/asteroid/airless,/area/ruin/unpowered)
"g" = (/mob/living/simple_animal/hostile/asteroid/goldgrub,/turf/open/floor/plating/asteroid/airless,/area/ruin/unpowered)
"h" = (/mob/living/simple_animal/hostile/asteroid/basilisk,/turf/open/floor/plating/asteroid/airless,/area/ruin/unpowered)
"i" = (/mob/living/simple_animal/hostile/asteroid/goliath,/turf/open/floor/plating/asteroid/airless,/area/ruin/unpowered)
"j" = (/obj/docking_port/stationary{dir = 2;dwidth = 11;height = 22;id = "whiteship_mining0";name = "Free Miner Asteroid";width = 35},/turf/open/space,/area/space)

(1,1,1) = {"
aaaaaaaaaaaaaaaaaaaaaaaaaaaaaaaaaaaaaaaaaaaaaaaaaaaaaaaaaaaaaaaaaaaaaaaaaaaaaaaa
aaaaaaaaaaaaaaaaaaaaaaaaaaaaaaaaaaaaaaaaaaaaaaaaaaaaaaaaaaaaaaaaaaaaaaaaaaaaaaaa
aaaaaaaaaaaaaaaaaaaaaaaaaaaaaaaaaaaaaaaaaaaaaaaaaaaaaaaaaaaaaaaaaaaaaaaaaaaaaaaa
aaaaaaaaaaaaaaaaaaaaaaaaaaaaaaaaaaaaaaaaaaaaaaaaaaaaaaaaaaaaaaaaaaaaaaaaaaaaaaaa
aaaaaaaaaaaaaaaaaaaaaaaaaaaaaaaaaaaaaaaaaaaaaaaaaaaaaaaaaaaaaaaaaaaaaaaaaaaaaaaa
aaaaaaaaaaaaaaaaaaaaaaaaaaaaaaaaaaaaaaaaaaaaaaaaaaaaaaaaaaaaaaaaaaaaaaaaaaaaaaaa
aaaaaaaaaaaaaaaaaaaaaaaaaaaaaaaaaaaaaaaaaaaaaaaaaaaaaaaaaaaaaaaaaaaaaaaaaaaaaaaa
aaaaaaaaaaaaaaaaaaaaaaaaaaaaaaaaaaaaaabaaaaaaaaaaaaaaaaaaaaaaaaaaaaaaaaaaaaaaaaa
aaaaaaaaaaaaaaaaaaaaaaaaaaaaaaaaaaaaaaaaaaaaaaaaaaaaaaacccaaaaaaaaaaaaaaaaaaaaaa
aaaaaaaaaaaaaaaaaaaaaaaaaaaaaaaaaaaaaaaaaaaaaaaaaacacaddddddaaaaaaaaaaaaaaaaaaaa
aaaaaaaaaaaaaaaaaaaaaaaaaaaccaccccaaacccaaaaaccacccccdddddddaaaaaaaaaaaaaaaaaaaa
aaaaaaaaaaaaaaaaaaaaaaaadddccdddddddddddddccdddddddddddddddddaaaaaaaaaaaaaaaaaaa
aaaaaaaaaaaaaaaaaaaaadaddddddddddddddddddccdddddddddddddddddddaaaaaaaaaaaaaaaaaa
aaaaaaaaaaaaaaaaaaaaddddddddddddddeddddddccdddddddddddddddddddddaaaaaaaaaaaaaaaa
aaaaaaaaaaaaaaaaaaeeeeddddddddddeeedddddccddddddddddeddddddddddddaaaaaaaaaaaaaaa
aaaaaaaaaaaaaaaaeeddeededdeeedeeeeedddddccdddddddddeeddeddddddddddaaaaaaaaaaaaaa
aaaaaaaaaaaaaddddddddeeeeeeeeeeeeeeddddccddddddddddedddeeeeddddedecaaaaaaaaaaaaa
aaaaaaaaaaaaadddddddeeeeeeeeeeeeeeeedddccdddddddddeeeeeeeeeddeddddeaaaaaaaaaaaaa
aaaaaaaaaaaadddddddddeeeeeeeeeeeeeeeddccdddddddedeeeeeeeeeeeddddddcaaaaaaaaaaaaa
aaaaaaaaaadddddddddddeeeeeeeeeeeeeeddcccddddddddeeeeeeeeeeeeddddddcaaaaaaaaaaaaa
aaaaaaaaadddddddddddedeeeeeeeeeeeeddcccddddddddddeeeeeeeeedddddddceaaaaaaaaaaaaa
aaaaaaaaddddddddddddddeeeeeeeeeeeeddccdddddddddddeeeeeeeeedddddddceaaaaaaaaaaaaa
aaaaaaadddddddeeeeedddddeeeeeeeeedddccddddddddddddeeeeeeeeeedddddccaaaaaaaaaaaaa
aaaaaaadddddddeccceddddedeeeeeeedddddcccdddddddddeeeeeeeeeeedddddccaaaaaaaaaaaaa
aaaaaaadddddddeccceddddddeeeeeeeedddddcccddddddddddeeeeeeeeedddddccaaaaaaaaaaaaa
aaaaaaadddddddecfceddddeeedeeeeeeddddddcccddddddddddeeeeeeeedddddccaaaaaaaaaaaaa
aaaaaaadddddddeeeeeddddddedeeeeeeeddddddcccddddddeeeeeeeeeeeedddddccaaaaaaaaaaaa
aaaaaaaddddddddddddddddddeddeeeeeeeddddddcccdddddeeeeeeeeeeeeeddddccaaaaaaaaaaaa
aaaaaaaadddddddddddddddddeedeeeeeeeeddddddcccdddddddeeeeeeeeedddddccaaaaaaaaaaaa
aaaaaaaddddddddddddddccddddedeeeeeeeeedddddcccdddddddeeeeeeeeddddddccaaaaaaaaaaa
aaaaaaaddddddddddddddcccdddddeeeeeeeeeeeedddcccddddddeddeeddeddddddccaaaaaaaaaaa
aaaaaaadddddddddddddddcccdddeeeeeeeeeeeeeedddcccdddddeddeeeddddddddccaaaaaaaaaaa
aaaaaaaadddddddddddddddcccddeeeeeeeeeeeeeedddddcdddddededceddddddddccaaaaaaaaaaa
aaaaaaaaddddddddddddddddccdddeeeeeeeeeeeeeeddddccdddddedgceddddddddcaaaaaaaaaaaa
aaaaaaaaadddddddddddddddcccddddeeeeeeeeeeeeedddccdddddeccceeeddddddcaaaaaaaaaaaa
aaaaaaaaaddddddddddddddddccdddddeeeeeeeeeeeedddccdddddeccdeedddddddcaaaaaaaaaaaa
aaaaaaaaaadddddeeeeddddddccddddddeeeeeeeeeeedddcccdddcccddeddddddddcaaaaaaaaaaaa
aaaaaaaaaadddddeccedddddddcccdddddeeeeeeeeeeeedcccdccccdddddeedddddcaaaaaaaaaaaa
aaaaaaaaaaaddddechedddddddddcddddddeeeeeeeeeeddcccccddddddddeeddddddaaaaaaaaaaaa
aaaaaaaaaaaddddeccedddddddddccdddddedeeeeeeeeddcccdddddddddeeeedddddaaaaaaaaaaaa
aaaaaaaaaaaddddeeceedddddddddccddddddeedeeeeeddcccddddddddeeddddddddaaaaaaaaaaaa
aaaaaaaaaaadddddecceddddddddddccdddddddddddddddccddddddddeeddeddddddaaaaaaaaaaaa
aaaaaaaaaaadddddeccddddddddddddccddddddddddddddccdddddddeeedeeddddddaaaaaaaaaaaa
aaaaaaaaaaadddddeccdddddddddddddccddddddddddddcccddddddeededdeddddddaaaaaaaaaaaa
aaaaaaaaaaaaddddddccdddddddddddddccdddddddddddcccdddddeeeeeeedddddddaaaaaaaaaaaa
aaaaaaaaaaadddddddccddddddddddddddccdddccddddcccdddddeeeeeeeddddddddaaaaaaaaaaaa
aaaaaaaaaaadddddddcccddddddddddddddccdddcddddccddddddeeeeeeddddddddcaaaaaaaaaaaa
aaaaaaaaaaaddddddddcccddddddddddddddccddccdcccdddddeeeeeeeeddddddddcaaaaaaaaaaaa
aaaaaaaaaaaddddddddcccdddddddddddddddccdccdccddddddeeeeeeedddddddccaaaaaaaaaaaaa
aaaaaaaaaaaaddddddddddddddddddddddddddccccccddddddeeeeeeeeddddddaaaaaaaaaaaaaaaa
aaaaaaaaaaaaddddddddddddeeeeddddddddddddcccddddddeeeeeeeeddddddaaaaaaaaaaaaaaaaa
aaaaaaaaaaaadddddddddddeeeeeeedddddddddcccdddddddeeeeeeeedddddaaaaaaaaaaaaaaaaaa
aaaaaaaaaaaadddddddddeeeeeeeeeeddddddddcccddddddeeeeeeeedddddaaaaaaaaaaaaaaaaaaa
aaaaaaaaaaaadddddddddeeeeccceeeeeedddddcccddddddeeeeeeeddddddaaaaaaaaaaaaaaaaaaa
aaaaaaaaaaaaddddddddeeeccccceeeeeedddddcccddddeeeeeeeedddddddaaaaaaaaaaaaaaaaaaa
aaaaaaaaaaaaddddddddeeeccicceeeeeedddddcccddddeedeeeeeddddddcaaaaaaaaaaaaaaaaaaa
aaaaaaaaaaaaadddddddeeecceeeeeeedddddddcccdddddddeeedddddddcaaaaaaaaaaaaaaaaaaaa
aaaaaaaaaaaaaaaddddddeeeceeeeeeddddddddcccddddddddedddddddcaaaaaaaaaaaaaaaaaaaaa
aaaaaaaaaaaaaaaadddddeeeeeeeeedddddddddccccdddddddddddddddcaaaaaaaaaaaaaaaaaaaaa
aaaaaaaaaaaaaaaaaddddeeeeeeeeedddddddddccccdddddddddddddddaaaaaaaaaaaaaaaaaaaaaa
aaaaaaaaaaaaaaaaacddddddddddddddddddddcccccdddddddddddddcaaaaaaaaaaaaaaaaaaaaaaa
aaaaaaaaaaaaaaaaaaaccddddddddddddddddccccccdddddcccccccccaaaaaaaaaaaaaaaaaaaaaaa
aaaaaaaaaaaaaaaaaaacccccddddddddddccccccccccccccccccccccaaaaaaaaaaaaaaaaaaaaaaaa
aaaaaaaaaaaaaaaaaaaacccccccdddddcccccccaaacccaacccccccccaaaaaaaaaaaaaaaaaaaaaaaa
aaaaaaaaaaaaaaaaaaaaacccccccccccccccccaaaaaaaaaaaaccccaaaaaaaaaaaaaaaaaaaaaaaaaa
aaaaaaaaaaaaaaaaaaaaaacccccccccaaaaaaaaaaaaaaaaaaaaaaaaaaaaaaaaaaaaaaaaaaaaaaaaa
aaaaaaaaaaaaaaaaaaaaaaaaaaaaaaaaaaaaaaaaaaaaaaaaaaaaaaaaaaaaaaaaaaaaaaaaaaaaaaaa
aaaaaaaaaaaaaaaaaaaaaaaaaaaaaaaaaaaaaaaaaaajaaaaaaaaaaaaaaaaaaaaaaaaaaaaaaaaaaaa
aaaaaaaaaaaaaaaaaaaaaaaaaaaaaaaaaaaaaaaaaaaaaaaaaaaaaaaaaaaaaaaaaaaaaaaaaaaaaaaa
aaaaaaaaaaaaaaaaaaaaaaaaaaaaaaaaaaaaaaaaaaaaaaaaaaaaaaaaaaaaaaaaaaaaaaaaaaaaaaaa
aaaaaaaaaaaaaaaaaaaaaaaaaaaaaaaaaaaaaaaaaaaaaaaaaaaaaaaaaaaaaaaaaaaaaaaaaaaaaaaa
aaaaaaaaaaaaaaaaaaaaaaaaaaaaaaaaaaaaaaaaaaaaaaaaaaaaaaaaaaaaaaaaaaaaaaaaaaaaaaaa
aaaaaaaaaaaaaaaaaaaaaaaaaaaaaaaaaaaaaaaaaaaaaaaaaaaaaaaaaaaaaaaaaaaaaaaaaaaaaaaa
aaaaaaaaaaaaaaaaaaaaaaaaaaaaaaaaaaaaaaaaaaaaaaaaaaaaaaaaaaaaaaaaaaaaaaaaaaaaaaaa
aaaaaaaaaaaaaaaaaaaaaaaaaaaaaaaaaaaaaaaaaaaaaaaaaaaaaaaaaaaaaaaaaaaaaaaaaaaaaaaa
aaaaaaaaaaaaaaaaaaaaaaaaaaaaaaaaaaaaaaaaaaaaaaaaaaaaaaaaaaaaaaaaaaaaaaaaaaaaaaaa
aaaaaaaaaaaaaaaaaaaaaaaaaaaaaaaaaaaaaaaaaaaaaaaaaaaaaaaaaaaaaaaaaaaaaaaaaaaaaaaa
aaaaaaaaaaaaaaaaaaaaaaaaaaaaaaaaaaaaaaaaaaaaaaaaaaaaaaaaaaaaaaaaaaaaaaaaaaaaaaaa
aaaaaaaaaaaaaaaaaaaaaaaaaaaaaaaaaaaaaaaaaaaaaaaaaaaaaaaaaaaaaaaaaaaaaaaaaaaaaaaa
aaaaaaaaaaaaaaaaaaaaaaaaaaaaaaaaaaaaaaaaaaaaaaaaaaaaaaaaaaaaaaaaaaaaaaaaaaaaaaaa
"}
