"a" = (/turf/open/space,/area/space)
"b" = (/turf/closed/mineral/random/low_chance,/area/ruin/unpowered)
"d" = (/turf/open/floor/plating/asteroid/airless,/area/ruin/unpowered)
"n" = (/mob/living/simple_animal/hostile/asteroid/goliath,/turf/open/floor/plating/asteroid/airless,/area/ruin/unpowered)
"s" = (/mob/living/simple_animal/hostile/asteroid/basilisk,/turf/open/floor/plating/asteroid/airless,/area/ruin/unpowered)
"D" = (/turf/closed/mineral/random/high_chance,/area/ruin/unpowered)
"I" = (/mob/living/simple_animal/hostile/asteroid/hivelord,/turf/open/floor/plating/asteroid/airless,/area/ruin/unpowered)
"K" = (/mob/living/simple_animal/hostile/asteroid/goldgrub,/turf/open/floor/plating/asteroid/airless,/area/ruin/unpowered)
"X" = (/obj/docking_port/stationary{dir = 2; dwidth = 11; height = 22; id = "whiteship_mining0"; name = "Free Miner Asteroid"; width = 35},/turf/open/space,/area/space)

(1,1,1) = {"
aaaaaaaaaaaaaaaaaaaaaaaaaaaaaaaaaaaaaaaaaaaaaaaaaaaaaaaaaaaaaaaaaaaaaaaaaaaaaaaa
aaaaaaaaaaaaaaaaaaaaaaaaaaaaaaaaaaaaaaaaaaaaaaaaaaaaaaaaaaaaaaaaaaaaaaaaaaaaaaaa
aaaaaaaaaaaaaaaaaaaaaaaaaaaaaaaaaaaaaaaaaaaaaaaaaaaaaaaaaaaaaaaaaaaaaaaaaaaaaaaa
aaaaaaaaaaaaaaaaaaaaaaaaaaaaaaaaaaaaaaaaaaaaaaaaaaaaaaaaaaaaaaaaaaaaaaaaaaaaaaaa
aaaaaaaaaaaaaaaaaaaaaaaaaaaaaaaaaaaaaaaaaaaaaaaaaaaaaaaaaaaaaaaaaaaaaaaaaaaaaaaa
aaaaaaaaaaaaaaaaaaaaaaaaaaaaaaaaaaaaaaaaaaaaaaaaaaaaaaaaaaaaaaaaaaaaaaaaaaaaaaaa
aaaaaaaaaaaaaaaaaaaaaaaaaaaaaaaaaaaaaaaaaaaaaaaaaaaaaaaaaaaaaaaaaaaaaaaaaaaaaaaa
aaaaaaaaaaaaaaaaaaaaaaaaaaaaaaaaaaaaaaaaaaaaaaaaaaaaaaaaaaaaaaaaaaaaaaaaaaaaaaaa
aaaaaaaaaaaaaaaaaaaaaaaaaaaaaaaaaaaaaaaaaaaaaaaaaaaaaaadddaaaaaaaaaaaaaaaaaaaaaa
aaaaaaaaaaaaaaaaaaaaaaaaaaaaaaaaaaaaaaaaaaaaaaaaaadadabbbbbbaaaaaaaaaaaaaaaaaaaa
aaaaaaaaaaaaaaaaaaaaaaaaaaaddaddddaaadddaaaaaddadddddbbbbbbbaaaaaaaaaaaaaaaaaaaa
aaaaaaaaaaaaaaaaaaaaaaaabbbddbbbbbbbbbbbbbddbbbbbbbbbbbbbbbbbaaaaaaaaaaaaaaaaaaa
aaaaaaaaaaaaaaaaaaaaababbbbbbbbbbbbbbbbbbddbbbbbbbbbbbbbbbbbbbaaaaaaaaaaaaaaaaaa
aaaaaaaaaaaaaaaaaaaabbbbbbbbbbbbbbDbbbbbbddbbbbbbbbbbbbbbbbbbbbbaaaaaaaaaaaaaaaa
aaaaaaaaaaaaaaaaaaDDDDbbbbbbbbbbDDDbbbbbddbbbbbbbbbbDbbbbbbbbbbbbaaaaaaaaaaaaaaa
aaaaaaaaaaaaaaaaDDbbDDbDbbDDDbDDDDDbbbbbddbbbbbbbbbDDbbDbbbbbbbbbbaaaaaaaaaaaaaa
aaaaaaaaaaaaabbbbbbbbDDDDDDDDDDDDDDbbbbddbbbbbbbbbbDbbbDDDDbbbbDbDdaaaaaaaaaaaaa
aaaaaaaaaaaaabbbbbbbDDDDDDDDDDDDDDDDbbbddbbbbbbbbbDDDDDDDDDbbDbbbbDaaaaaaaaaaaaa
aaaaaaaaaaaabbbbbbbbbDDDDDDDDDDDDDDDbbddbbbbbbbDbDDDDDDDDDDDbbbbbbdaaaaaaaaaaaaa
aaaaaaaaaabbbbbbbbbbbDDDDDDDDDDDDDDbbdddbbbbbbbbDDDDDDDDDDDDbbbbbbdaaaaaaaaaaaaa
aaaaaaaaabbbbbbbbbbbDbDDDDDDDDDDDDbbdddbbbbbbbbbbDDDDDDDDDbbbbbbbdDaaaaaaaaaaaaa
aaaaaaaabbbbbbbbbbbbbbDDDDDDDDDDDDbbddbbbbbbbbbbbDDDDDDDDDbbbbbbbdDaaaaaaaaaaaaa
aaaaaaabbbbbbbDDDDDbbbbbDDDDDDDDDbbbddbbbbbbbbbbbbDDDDDDDDDDbbbbbddaaaaaaaaaaaaa
aaaaaaabbbbbbbDdddDbbbbDbDDDDDDDbbbbbdddbbbbbbbbbDDDDDDDDDDDbbbbbddaaaaaaaaaaaaa
aaaaaaabbbbbbbDdddDbbbbbbDDDDDDDDbbbbbdddbbbbbbbbbbDDDDDDDDDbbbbbddaaaaaaaaaaaaa
aaaaaaabbbbbbbDdIdDbbbbDDDbDDDDDDbbbbbbdddbbbbbbbbbbDDDDDDDDbbbbbddaaaaaaaaaaaaa
aaaaaaabbbbbbbDDDDDbbbbbbDbDDDDDDDbbbbbbdddbbbbbbDDDDDDDDDDDDbbbbbddaaaaaaaaaaaa
aaaaaaabbbbbbbbbbbbbbbbbbDbbDDDDDDDbbbbbbdddbbbbbDDDDDDDDDDDDDbbbbddaaaaaaaaaaaa
aaaaaaaabbbbbbbbbbbbbbbbbDDbDDDDDDDDbbbbbbdddbbbbbbbDDDDDDDDDbbbbbddaaaaaaaaaaaa
aaaaaaabbbbbbbbbbbbbbddbbbbDbDDDDDDDDDbbbbbdddbbbbbbbDDDDDDDDbbbbbbddaaaaaaaaaaa
aaaaaaabbbbbbbbbbbbbbdddbbbbbDDDDDDDDDDDDbbbdddbbbbbbDbbDDbbDbbbbbbddaaaaaaaaaaa
aaaaaaabbbbbbbbbbbbbbbdddbbbDDDDDDDDDDDDDDbbbdddbbbbbDbbDDDbbbbbbbbddaaaaaaaaaaa
aaaaaaaabbbbbbbbbbbbbbbdddbbDDDDDDDDDDDDDDbbbbbdbbbbbDbDbdDbbbbbbbbddaaaaaaaaaaa
aaaaaaaabbbbbbbbbbbbbbbbddbbbDDDDDDDDDDDDDDbbbbddbbbbbDbKdDbbbbbbbbdaaaaaaaaaaaa
aaaaaaaaabbbbbbbbbbbbbbbdddbbbbDDDDDDDDDDDDDbbbddbbbbbDdddDDDbbbbbbdaaaaaaaaaaaa
aaaaaaaaabbbbbbbbbbbbbbbbddbbbbbDDDDDDDDDDDDbbbddbbbbbDddbDDbbbbbbbdaaaaaaaaaaaa
aaaaaaaaaabbbbbDDDDbbbbbbddbbbbbbDDDDDDDDDDDbbbdddbbbdddbbDbbbbbbbbdaaaaaaaaaaaa
aaaaaaaaaabbbbbDddDbbbbbbbdddbbbbbDDDDDDDDDDDDbdddbddddbbbbbDDbbbbbdaaaaaaaaaaaa
aaaaaaaaaaabbbbDdsDbbbbbbbbbdbbbbbbDDDDDDDDDDbbdddddbbbbbbbbDDbbbbbbaaaaaaaaaaaa
aaaaaaaaaaabbbbDddDbbbbbbbbbddbbbbbDbDDDDDDDDbbdddbbbbbbbbbDDDDbbbbbaaaaaaaaaaaa
aaaaaaaaaaabbbbDDdDDbbbbbbbbbddbbbbbbDDbDDDDDbbdddbbbbbbbbDDbbbbbbbbaaaaaaaaaaaa
aaaaaaaaaaabbbbbDddDbbbbbbbbbbddbbbbbbbbbbbbbbbddbbbbbbbbDDbbDbbbbbbaaaaaaaaaaaa
aaaaaaaaaaabbbbbDddbbbbbbbbbbbbddbbbbbbbbbbbbbbddbbbbbbbDDDbDDbbbbbbaaaaaaaaaaaa
aaaaaaaaaaabbbbbDddbbbbbbbbbbbbbddbbbbbbbbbbbbdddbbbbbbDDbDbbDbbbbbbaaaaaaaaaaaa
aaaaaaaaaaaabbbbbbddbbbbbbbbbbbbbddbbbbbbbbbbbdddbbbbbDDDDDDDbbbbbbbaaaaaaaaaaaa
aaaaaaaaaaabbbbbbbddbbbbbbbbbbbbbbddbbbddbbbbdddbbbbbDDDDDDDbbbbbbbbaaaaaaaaaaaa
aaaaaaaaaaabbbbbbbdddbbbbbbbbbbbbbbddbbbdbbbbddbbbbbbDDDDDDbbbbbbbbdaaaaaaaaaaaa
aaaaaaaaaaabbbbbbbbdddbbbbbbbbbbbbbbddbbddbdddbbbbbDDDDDDDDbbbbbbbbdaaaaaaaaaaaa
aaaaaaaaaaabbbbbbbbdddbbbbbbbbbbbbbbbddbddbddbbbbbbDDDDDDDbbbbbbbddaaaaaaaaaaaaa
aaaaaaaaaaaabbbbbbbbbbbbbbbbbbbbbbbbbbddddddbbbbbbDDDDDDDDbbbbbbaaaaaaaaaaaaaaaa
aaaaaaaaaaaabbbbbbbbbbbbDDDDbbbbbbbbbbbbdddbbbbbbDDDDDDDDbbbbbbaaaaaaaaaaaaaaaaa
aaaaaaaaaaaabbbbbbbbbbbDDDDDDDbbbbbbbbbdddbbbbbbbDDDDDDDDbbbbbaaaaaaaaaaaaaaaaaa
aaaaaaaaaaaabbbbbbbbbDDDDDDDDDDbbbbbbbbdddbbbbbbDDDDDDDDbbbbbaaaaaaaaaaaaaaaaaaa
aaaaaaaaaaaabbbbbbbbbDDDDdddDDDDDDbbbbbdddbbbbbbDDDDDDDbbbbbbaaaaaaaaaaaaaaaaaaa
aaaaaaaaaaaabbbbbbbbDDDdddddDDDDDDbbbbbdddbbbbDDDDDDDDbbbbbbbaaaaaaaaaaaaaaaaaaa
aaaaaaaaaaaabbbbbbbbDDDddnddDDDDDDbbbbbdddbbbbDDbDDDDDbbbbbbdaaaaaaaaaaaaaaaaaaa
aaaaaaaaaaaaabbbbbbbDDDddDDDDDDDbbbbbbbdddbbbbbbbDDDbbbbbbbdaaaaaaaaaaaaaaaaaaaa
aaaaaaaaaaaaaaabbbbbbDDDdDDDDDDbbbbbbbbdddbbbbbbbbDbbbbbbbdaaaaaaaaaaaaaaaaaaaaa
aaaaaaaaaaaaaaaabbbbbDDDDDDDDDbbbbbbbbbddddbbbbbbbbbbbbbbbdaaaaaaaaaaaaaaaaaaaaa
aaaaaaaaaaaaaaaaabbbbDDDDDDDDDbbbbbbbbbddddbbbbbbbbbbbbbbbaaaaaaaaaaaaaaaaaaaaaa
aaaaaaaaaaaaaaaaadbbbbbbbbbbbbbbbbbbbbdddddbbbbbbbbbbbbbdaaaaaaaaaaaaaaaaaaaaaaa
aaaaaaaaaaaaaaaaaaaddbbbbbbbbbbbbbbbbddddddbbbbbdddddddddaaaaaaaaaaaaaaaaaaaaaaa
aaaaaaaaaaaaaaaaaaadddddbbbbbbbbbbddddddddddddddddddddddaaaaaaaaaaaaaaaaaaaaaaaa
aaaaaaaaaaaaaaaaaaaadddddddbbbbbdddddddaaadddaadddddddddaaaaaaaaaaaaaaaaaaaaaaaa
aaaaaaaaaaaaaaaaaaaaadddddddddddddddddaaaaaaaaaaaaddddaaaaaaaaaaaaaaaaaaaaaaaaaa
aaaaaaaaaaaaaaaaaaaaaadddddddddaaaaaaaaaaaaaaaaaaaaaaaaaaaaaaaaaaaaaaaaaaaaaaaaa
aaaaaaaaaaaaaaaaaaaaaaaaaaaaaaaaaaaaaaaaaaaaaaaaaaaaaaaaaaaaaaaaaaaaaaaaaaaaaaaa
aaaaaaaaaaaaaaaaaaaaaaaaaaaaaaaaaaaaaaaaaaaXaaaaaaaaaaaaaaaaaaaaaaaaaaaaaaaaaaaa
aaaaaaaaaaaaaaaaaaaaaaaaaaaaaaaaaaaaaaaaaaaaaaaaaaaaaaaaaaaaaaaaaaaaaaaaaaaaaaaa
aaaaaaaaaaaaaaaaaaaaaaaaaaaaaaaaaaaaaaaaaaaaaaaaaaaaaaaaaaaaaaaaaaaaaaaaaaaaaaaa
aaaaaaaaaaaaaaaaaaaaaaaaaaaaaaaaaaaaaaaaaaaaaaaaaaaaaaaaaaaaaaaaaaaaaaaaaaaaaaaa
aaaaaaaaaaaaaaaaaaaaaaaaaaaaaaaaaaaaaaaaaaaaaaaaaaaaaaaaaaaaaaaaaaaaaaaaaaaaaaaa
aaaaaaaaaaaaaaaaaaaaaaaaaaaaaaaaaaaaaaaaaaaaaaaaaaaaaaaaaaaaaaaaaaaaaaaaaaaaaaaa
aaaaaaaaaaaaaaaaaaaaaaaaaaaaaaaaaaaaaaaaaaaaaaaaaaaaaaaaaaaaaaaaaaaaaaaaaaaaaaaa
aaaaaaaaaaaaaaaaaaaaaaaaaaaaaaaaaaaaaaaaaaaaaaaaaaaaaaaaaaaaaaaaaaaaaaaaaaaaaaaa
aaaaaaaaaaaaaaaaaaaaaaaaaaaaaaaaaaaaaaaaaaaaaaaaaaaaaaaaaaaaaaaaaaaaaaaaaaaaaaaa
aaaaaaaaaaaaaaaaaaaaaaaaaaaaaaaaaaaaaaaaaaaaaaaaaaaaaaaaaaaaaaaaaaaaaaaaaaaaaaaa
aaaaaaaaaaaaaaaaaaaaaaaaaaaaaaaaaaaaaaaaaaaaaaaaaaaaaaaaaaaaaaaaaaaaaaaaaaaaaaaa
aaaaaaaaaaaaaaaaaaaaaaaaaaaaaaaaaaaaaaaaaaaaaaaaaaaaaaaaaaaaaaaaaaaaaaaaaaaaaaaa
aaaaaaaaaaaaaaaaaaaaaaaaaaaaaaaaaaaaaaaaaaaaaaaaaaaaaaaaaaaaaaaaaaaaaaaaaaaaaaaa
"}

