"aa" = (/turf/open/space,/area/space)
"ab" = (/turf/open/space,/turf/closed/wall/shuttle{icon_state = "swall_f6"; dir = 2},/area/shuttle/escape)
"ac" = (/obj/structure/grille,/obj/structure/window/shuttle,/turf/open/floor/plating,/area/shuttle/escape)
"ad" = (/turf/open/space,/turf/closed/wall/shuttle{dir = 2; icon_state = "swall_f10"; layer = 2},/area/shuttle/escape)
"ae" = (/turf/open/floor/plasteel/shuttle/white,/turf/closed/wall/shuttle/interior{icon_state = "swall_f9"},/area/shuttle/escape)
"af" = (/obj/structure/table,/turf/open/floor/plasteel/shuttle/white,/area/shuttle/escape)
"ag" = (/obj/structure/chair/shuttle,/turf/open/floor/plasteel/shuttle,/area/shuttle/escape)
"ah" = (/obj/machinery/computer/emergency_shuttle,/turf/open/floor/plasteel/shuttle,/area/shuttle/escape)
"ai" = (/obj/structure/table,/obj/item/weapon/storage/firstaid/regular,/obj/item/weapon/storage/firstaid/fire{pixel_x = 4},/turf/open/floor/plasteel/shuttle/white,/area/shuttle/escape)
"aj" = (/turf/open/floor/plasteel/shuttle/white,/turf/closed/wall/shuttle/interior{icon_state = "swall_f5"},/area/shuttle/escape)
"ak" = (/obj/machinery/computer/atmos_alert{dir = 4},/turf/open/floor/plasteel/shuttle/white,/area/shuttle/escape)
"al" = (/obj/structure/chair/shuttle{dir = 8},/turf/open/floor/plasteel/shuttle,/area/shuttle/escape)
"am" = (/turf/open/floor/plasteel/shuttle,/area/shuttle/escape)
"an" = (/obj/structure/chair/comfy/lime{dir = 1},/turf/open/floor/plasteel/shuttle,/area/shuttle/escape)
"ao" = (/obj/structure/chair/shuttle{dir = 4},/turf/open/floor/plasteel/shuttle,/area/shuttle/escape)
"ap" = (/obj/machinery/computer/security{dir = 8},/turf/open/floor/plasteel/shuttle/white,/area/shuttle/escape)
"aq" = (/turf/closed/wall/shuttle{icon_state = "swall11"; dir = 2},/area/shuttle/escape)
"ar" = (/obj/machinery/computer/crew{dir = 4},/turf/open/floor/plasteel/shuttle/white,/area/shuttle/escape)
"as" = (/obj/machinery/button/flasher{id = "cockpit_flasher"; pixel_x = 6; pixel_y = -24},/turf/open/floor/plasteel/shuttle,/area/shuttle/escape)
"at" = (/obj/machinery/computer/communications{dir = 8},/turf/open/floor/plasteel/shuttle/white,/area/shuttle/escape)
"au" = (/turf/closed/wall/shuttle{icon_state = "swall7"; dir = 2},/area/shuttle/escape)
"av" = (/turf/closed/wall/shuttle{icon_state = "swall13"; dir = 2},/area/shuttle/escape)
"aw" = (/turf/closed/wall/shuttle{icon_state = "swall12"; dir = 2},/area/shuttle/escape)
"ax" = (/turf/closed/wall/shuttle{icon_state = "swall14"; dir = 2},/area/shuttle/escape)
"ay" = (/obj/machinery/door/airlock/glass{name = "Emergency Shuttle Cockpit"; req_access_txt = "19"},/turf/open/floor/plasteel/shuttle,/area/shuttle/escape)
"az" = (/obj/machinery/status_display,/turf/closed/wall/shuttle{icon_state = "swall12"; dir = 2},/area/shuttle/escape)
"aA" = (/turf/closed/wall/shuttle{icon_state = "swall3"; dir = 2},/area/shuttle/escape)
"aB" = (/obj/structure/chair,/turf/open/floor/plasteel/shuttle/red,/area/shuttle/escape)
"aC" = (/obj/machinery/flasher{id = "shuttlebrig"; pixel_y = 24},/turf/open/floor/plasteel/shuttle/red,/area/shuttle/escape)
"aD" = (/obj/structure/chair{dir = 8},/turf/open/floor/plasteel/shuttle/red,/area/shuttle/escape)
"aE" = (/obj/machinery/flasher{id = "cockpit_flasher"; pixel_x = 6; pixel_y = 24},/turf/open/floor/plasteel/shuttle/white,/area/shuttle/escape)
"aF" = (/turf/open/floor/plasteel/shuttle/white,/area/shuttle/escape)
"aG" = (/obj/structure/extinguisher_cabinet{pixel_y = 30},/turf/open/floor/plasteel/shuttle/white,/area/shuttle/escape)
"aH" = (/obj/structure/closet/emcloset,/turf/open/floor/plasteel/shuttle/white,/area/shuttle/escape)
"aI" = (/turf/open/floor/plasteel/shuttle/red,/area/shuttle/escape)
"aJ" = (/obj/structure/chair{dir = 1},/turf/open/floor/plasteel/shuttle/red,/area/shuttle/escape)
"aK" = (/obj/structure/chair/shuttle,/turf/open/floor/plasteel/shuttle/white,/area/shuttle/escape)
"aL" = (/obj/structure/chair/shuttle{dir = 8},/turf/open/floor/plasteel/shuttle/white,/area/shuttle/escape)
"aM" = (/obj/structure/grille,/obj/structure/window/shuttle,/turf/open/floor/plasteel/shuttle/red,/area/shuttle/escape)
"aN" = (/obj/machinery/door/airlock/glass_security{name = "Holding Area"},/turf/open/floor/plasteel/shuttle/red,/area/shuttle/escape)
"aO" = (/obj/structure/chair,/obj/machinery/button/flasher{id = "shuttlebrig"; pixel_x = -22; req_access_txt = "2"},/turf/open/floor/plasteel/shuttle/red,/area/shuttle/escape)
"aP" = (/obj/machinery/door/airlock/shuttle{name = "Emergency Shuttle Airlock"},/turf/open/floor/plasteel/shuttle/red,/area/shuttle/escape)
"aQ" = (/obj/structure/extinguisher_cabinet{pixel_y = -30},/turf/open/floor/plasteel/shuttle/red,/area/shuttle/escape)
"aR" = (/obj/machinery/door/airlock/glass{name = "Emergency Shuttle Brig"; req_access_txt = "2"},/turf/open/floor/plasteel/shuttle/red,/area/shuttle/escape)
"aS" = (/obj/structure/chair/shuttle{dir = 1},/obj/structure/window/reinforced,/turf/open/floor/plasteel/shuttle/white,/area/shuttle/escape)
"aT" = (/obj/machinery/status_display,/turf/closed/wall/shuttle{icon_state = "swallc4"; dir = 2},/area/shuttle/escape)
"aU" = (/obj/structure/chair/shuttle,/obj/structure/window/reinforced{dir = 1},/turf/open/floor/plasteel/shuttle/white,/area/shuttle/escape)
"aV" = (/obj/machinery/door/airlock/shuttle{name = "Emergency Shuttle Airlock"},/obj/docking_port/mobile/emergency{dwidth = 12; height = 13; name = "The Undying Classic"; timid = 0; width = 27},/obj/docking_port/stationary{dir = 4; dwidth = 12; height = 18; id = "emergency_home"; name = "BoxStation emergency evac bay"; width = 32},/turf/open/floor/plasteel/shuttle,/area/shuttle/escape)
"aW" = (/obj/structure/extinguisher_cabinet{pixel_x = 24},/turf/open/floor/plasteel/shuttle,/area/shuttle/escape)
"aX" = (/obj/structure/chair/shuttle{dir = 4},/turf/open/floor/plasteel/shuttle/white,/area/shuttle/escape)
"aY" = (/obj/machinery/door/airlock/shuttle{name = "Emergency Shuttle Airlock"},/turf/open/floor/plasteel/shuttle,/area/shuttle/escape)
"aZ" = (/obj/machinery/door/airlock/glass_large,/turf/open/floor/plasteel/shuttle/white,/area/shuttle/escape)
"ba" = (/obj/machinery/status_display,/turf/closed/wall/shuttle{icon_state = "swall14"; dir = 2},/area/shuttle/escape)
"bb" = (/obj/structure/window/reinforced{dir = 1},/obj/structure/window/reinforced{dir = 8},/turf/open/floor/plasteel/shuttle/white,/area/shuttle/escape)
"bc" = (/obj/machinery/door/window/northright,/turf/open/floor/plasteel/shuttle/white,/area/shuttle/escape)
"bd" = (/obj/structure/window/reinforced{dir = 1},/obj/structure/chair/shuttle{dir = 8},/turf/open/floor/plasteel/shuttle/white,/area/shuttle/escape)
"be" = (/obj/machinery/door/airlock/shuttle{name = "Emergency Shuttle Airlock"},/turf/open/floor/plasteel/shuttle/white,/area/shuttle/escape)
"bf" = (/obj/machinery/sleeper{icon_state = "sleeper-open"; dir = 8},/turf/open/floor/plasteel/shuttle/white,/area/shuttle/escape)
"bg" = (/obj/structure/window/reinforced{dir = 8},/turf/open/floor/carpet,/area/shuttle/escape)
"bh" = (/obj/item/weapon/reagent_containers/food/snacks/soup/mystery{desc = "Is this safe for humans?"; name = "dog food"},/turf/open/floor/plasteel/shuttle/white,/area/shuttle/escape)
"bi" = (/obj/structure/table,/obj/item/weapon/reagent_containers/blood/random,/obj/item/weapon/reagent_containers/blood/random,/obj/item/weapon/reagent_containers/blood/random,/turf/open/floor/plasteel/shuttle/white,/area/shuttle/escape)
"bj" = (/obj/structure/closet,/turf/open/floor/plasteel/shuttle/yellow,/area/shuttle/escape)
"bk" = (/obj/structure/bodycontainer/morgue,/turf/open/floor/plasteel/shuttle/white,/area/shuttle/escape)
"bl" = (/obj/machinery/iv_drip,/turf/open/floor/plasteel/shuttle/white,/area/shuttle/escape)
"bm" = (/turf/open/floor/plasteel/shuttle/yellow,/area/shuttle/escape)
"bn" = (/obj/machinery/vending/cola,/turf/open/floor/plasteel/shuttle/white,/area/shuttle/escape)
"bo" = (/obj/machinery/vending/snack,/turf/open/floor/plasteel/shuttle/white,/area/shuttle/escape)
"bp" = (/obj/structure/closet/crate,/turf/open/floor/plasteel/shuttle/yellow,/area/shuttle/escape)
"bq" = (/turf/open/space,/turf/closed/wall/shuttle{icon_state = "swall_f5"; dir = 2},/area/shuttle/escape)
"br" = (/turf/closed/wall/shuttle{icon_state = "swall15"; dir = 2},/area/shuttle/escape)
"bs" = (/turf/open/space,/turf/closed/wall/shuttle{icon_state = "swall_f9"; dir = 2},/area/shuttle/escape)
"bt" = (/obj/structure/shuttle/engine/propulsion,/turf/open/floor/plating/airless,/area/shuttle/escape)
"bu" = (/turf/closed/wall/shuttle{icon_state = "swall1"; dir = 2},/area/shuttle/escape)

(1,1,1) = {"
aaaaaaabacacacacacadaaaaaa
aaaaabaeafagahagaiajadaaaa
aaaaacakalamanamaoapacaaaa
aaabaqaralamasamaoatauadaa
abavavawawaxawayazawavavad
aAaBaBaCaDaAaEamaFaGaHaiaA
acaIaIaIaDacaFamamamamamac
aAaJaJaIaDaAaKaKaKafamaLaA
auaMaMaNaMaqafafafafamaLaA
aAaOaBaIaIacamamamamamaLaA
aPaIaIaIaQaRamaSaSaSamaLac
auawacacawaTamaUaUaUamaLaA
aVamamamamamamamamamamaWaA
aAaXamaSaSaSamaSaSaSamaLaA
acaXamaUaUaUamaUaUaUamamaY
acaXamamamamamamamamamamaY
acaXamaSaSaSamaSaSaSamamaY
aAaXamaUaUaUamaUaUaUamaLaA
aYamamamamamamamamamamaWaA
auacaZaFacawbaamambbbcbdaA
beaFaFaFaFbfaAamambgaFbhac
aAaHaFaFaFbfaAamamauawawaq
acaHaFbiaFaiacamaWaAbjbjac
aAbkaFblaFbfaAamamaYbmbmaA
aAbkaFaFaFbfaAbnboaAbpbpaA
bqaxacacacacbracacacacaxbs
aabqbtbtbtbtbubtbtbtbtbsaa
"}
