"aa" = (/turf/open/space,/area/space)
"ab" = (/turf/closed/wall/shuttle/smooth,/area/shuttle/escape)
"ac" = (/obj/structure/grille,/obj/structure/window/shuttle,/turf/open/floor/plating/airless,/area/shuttle/escape)
"ad" = (/turf/closed/wall/shuttle/smooth/nodiagonal,/area/shuttle/escape)
"ae" = (/obj/machinery/computer/communications,/turf/open/floor/plasteel/shuttle,/area/shuttle/escape)
"af" = (/obj/machinery/computer/crew,/turf/open/floor/plasteel/shuttle,/area/shuttle/escape)
"ag" = (/obj/machinery/computer/emergency_shuttle,/turf/open/floor/plasteel/shuttle,/area/shuttle/escape)
"ah" = (/obj/machinery/computer/station_alert,/turf/open/floor/plasteel/shuttle,/area/shuttle/escape)
"ai" = (/obj/structure/chair{tag = "icon-chair_shuttle (WEST)"; icon_state = "chair_shuttle"; dir = 8},/turf/open/floor/plasteel/shuttle/yellow,/area/shuttle/escape)
"aj" = (/obj/structure/chair{tag = "icon-chair_shuttle (NORTH)"; icon_state = "chair_shuttle"; dir = 1},/turf/open/floor/plasteel/shuttle/yellow,/area/shuttle/escape)
"ak" = (/obj/structure/table,/obj/item/weapon/storage/firstaid/regular,/turf/open/floor/plasteel/shuttle,/area/shuttle/escape)
"al" = (/obj/structure/table,/obj/item/weapon/storage/firstaid/toxin,/turf/open/floor/plasteel/shuttle,/area/shuttle/escape)
"am" = (/obj/structure/table,/obj/item/weapon/storage/firstaid/fire,/turf/open/floor/plasteel/shuttle,/area/shuttle/escape)
"an" = (/obj/structure/chair{tag = "icon-chair_shuttle (EAST)"; icon_state = "chair_shuttle"; dir = 4},/turf/open/floor/plasteel/shuttle/yellow,/area/shuttle/escape)
"ao" = (/obj/machinery/computer/secure_data,/turf/open/floor/plasteel/shuttle,/area/shuttle/escape)
"ap" = (/obj/machinery/computer/robotics,/turf/open/floor/plasteel/shuttle,/area/shuttle/escape)
"aq" = (/obj/structure/chair{tag = "icon-chair_shuttle (WEST)"; icon_state = "chair_shuttle"; dir = 8},/obj/machinery/light,/turf/open/floor/plasteel/shuttle/yellow,/area/shuttle/escape)
"ar" = (/turf/open/floor/plasteel/shuttle/yellow,/area/shuttle/escape)
"as" = (/obj/structure/chair{tag = "icon-chair_shuttle (EAST)"; icon_state = "chair_shuttle"; dir = 4},/obj/machinery/light,/turf/open/floor/plasteel/shuttle/yellow,/area/shuttle/escape)
"at" = (/obj/machinery/computer/card,/turf/open/floor/plasteel/shuttle,/area/shuttle/escape)
"au" = (/obj/machinery/status_display,/turf/closed/wall/shuttle/smooth/nodiagonal,/area/shuttle/escape)
"av" = (/obj/machinery/door/airlock/glass_command{name = "Escape Shuttle Cockpit"; req_access_txt = "19"},/turf/open/floor/plasteel/shuttle/yellow,/area/shuttle/escape)
"aw" = (/obj/structure/table,/obj/item/weapon/storage/firstaid/o2,/obj/item/weapon/storage/firstaid/toxin,/turf/open/floor/plasteel/shuttle/white,/area/shuttle/escape)
"ax" = (/obj/machinery/light{dir = 1},/turf/open/floor/plasteel/shuttle/white,/area/shuttle/escape)
"ay" = (/obj/structure/chair{tag = "icon-chair_shuttle (WEST)"; icon_state = "chair_shuttle"; dir = 8},/turf/open/floor/plasteel/shuttle/white,/area/shuttle/escape)
"az" = (/obj/structure/chair{tag = "icon-chair_shuttle"; icon_state = "chair_shuttle"},/turf/open/floor/plasteel/shuttle,/area/shuttle/escape)
"aA" = (/obj/structure/flora/kirbyplants{tag = "icon-plant-10"; icon_state = "plant-10"},/obj/structure/window/reinforced{dir = 8},/turf/open/floor/plasteel/shuttle,/area/shuttle/escape)
"aB" = (/obj/structure/flora/kirbyplants{tag = "icon-plant-10"; icon_state = "plant-10"},/obj/machinery/light{dir = 1},/turf/open/floor/plasteel/shuttle,/area/shuttle/escape)
"aC" = (/obj/structure/table,/obj/item/weapon/storage/firstaid/brute,/obj/item/weapon/storage/firstaid/fire,/turf/open/floor/plasteel/shuttle/white,/area/shuttle/escape)
"aD" = (/turf/open/floor/plasteel/shuttle/white,/area/shuttle/escape)
"aE" = (/obj/structure/chair{tag = "icon-chair_shuttle (WEST)"; icon_state = "chair_shuttle"; dir = 8},/turf/open/floor/plasteel/shuttle,/area/shuttle/escape)
"aF" = (/obj/machinery/sleeper{icon_state = "sleeper-open"; dir = 4},/turf/open/floor/plasteel/shuttle/white,/area/shuttle/escape)
"aG" = (/obj/machinery/light,/turf/open/floor/plasteel/shuttle/white,/area/shuttle/escape)
"aH" = (/obj/machinery/door/airlock/glass_virology{name = "Escape Shuttle Infirmary"},/turf/open/floor/plasteel/shuttle/white,/area/shuttle/escape)
"aI" = (/obj/machinery/door/airlock/glass,/turf/open/floor/plasteel/shuttle/yellow,/area/shuttle/escape)
"aJ" = (/obj/machinery/door/airlock/shuttle,/obj/docking_port/mobile/emergency{dwidth = 10; timid = 1; width = 26},/turf/open/floor/plasteel/shuttle/yellow,/area/shuttle/escape)
"aK" = (/obj/structure/table,/turf/open/floor/plasteel/shuttle,/area/shuttle/escape)
"aL" = (/obj/structure/closet/emcloset,/turf/open/floor/plasteel/shuttle,/area/shuttle/escape)
"aM" = (/obj/structure/chair{tag = "icon-chair_shuttle (NORTH)"; icon_state = "chair_shuttle"; dir = 1},/turf/open/floor/plasteel/shuttle,/area/shuttle/escape)
"aN" = (/obj/machinery/door/airlock/shuttle,/turf/open/floor/plasteel/shuttle/yellow,/area/shuttle/escape)
"aO" = (/obj/structure/chair{tag = "icon-chair_shuttle (EAST)"; icon_state = "chair_shuttle"; dir = 4},/obj/machinery/light{dir = 8},/turf/open/floor/plasteel/shuttle,/area/shuttle/escape)
"aP" = (/obj/structure/chair{tag = "icon-chair_shuttle (WEST)"; icon_state = "chair_shuttle"; dir = 8},/obj/machinery/light{icon_state = "tube1"; dir = 4},/turf/open/floor/plasteel/shuttle,/area/shuttle/escape)
"aQ" = (/obj/machinery/door/airlock/maintenance_hatch,/turf/open/floor/plating,/area/shuttle/escape)
"aR" = (/obj/machinery/door/airlock/glass_security{name = "Escape Shuttle Brig"; req_access_txt = "2"},/turf/open/floor/plasteel/shuttle/red,/area/shuttle/escape)
"aS" = (/obj/structure/reagent_dispensers/watertank,/turf/open/floor/plating,/area/shuttle/escape)
"aT" = (/turf/open/floor/plating,/area/shuttle/escape)
"aU" = (/obj/structure/table,/obj/item/weapon/storage/toolbox,/obj/machinery/light/small{dir = 4},/turf/open/floor/plating,/area/shuttle/escape)
"aV" = (/obj/structure/table,/turf/open/floor/plasteel/shuttle/red,/area/shuttle/escape)
"aW" = (/obj/structure/chair{tag = "icon-chair_shuttle"; icon_state = "chair_shuttle"},/turf/open/floor/plasteel/shuttle/red,/area/shuttle/escape)
"aX" = (/turf/open/floor/plasteel/shuttle/red,/area/shuttle/escape)
"aY" = (/obj/structure/chair{tag = "icon-chair_shuttle (WEST)"; icon_state = "chair_shuttle"; dir = 8},/turf/open/floor/plasteel/shuttle/red,/area/shuttle/escape)
"aZ" = (/obj/machinery/light/small{dir = 8},/turf/open/floor/plating,/area/shuttle/escape)
"ba" = (/obj/structure/table,/obj/item/weapon/extinguisher,/turf/open/floor/plating,/area/shuttle/escape)
"bb" = (/obj/structure/chair{tag = "icon-chair_shuttle (EAST)"; icon_state = "chair_shuttle"; dir = 4},/turf/open/floor/plasteel/shuttle/red,/area/shuttle/escape)
"bc" = (/obj/machinery/door/airlock/glass_engineering{name = "Engineering Hatch"},/turf/open/floor/plating,/area/shuttle/escape)
"bd" = (/obj/structure/window/reinforced,/obj/structure/chair{tag = "icon-chair_shuttle (EAST)"; icon_state = "chair_shuttle"; dir = 4},/obj/machinery/light{dir = 8},/turf/open/floor/plasteel/shuttle/red,/area/shuttle/escape)
"be" = (/obj/structure/window/reinforced,/turf/open/floor/plasteel/shuttle/red,/area/shuttle/escape)
"bf" = (/obj/machinery/door/window/brigdoor,/turf/open/floor/plasteel/shuttle/red,/area/shuttle/escape)
"bg" = (/obj/structure/window/reinforced,/obj/machinery/light{icon_state = "tube1"; dir = 4},/turf/open/floor/plasteel/shuttle/red,/area/shuttle/escape)
"bh" = (/obj/structure/closet/toolcloset,/turf/open/floor/plating,/area/shuttle/escape)
"bi" = (/obj/machinery/portable_atmospherics/canister/oxygen,/turf/open/floor/plating,/area/shuttle/escape)
"bj" = (/obj/machinery/portable_atmospherics/canister/air,/obj/machinery/light/small{dir = 1},/turf/open/floor/plating,/area/shuttle/escape)
"bk" = (/obj/machinery/portable_atmospherics/canister/air,/turf/open/floor/plating,/area/shuttle/escape)
"bl" = (/obj/structure/window/reinforced{dir = 1},/obj/structure/shuttle/engine/heater,/turf/open/floor/plating/airless,/area/shuttle/escape)
"bm" = (/obj/structure/shuttle/engine/propulsion,/turf/open/floor/plating/airless,/area/shuttle/escape)

(1,1,1) = {"
aaabacacabaaabacacabaa
abadaeafadadadagaeabab
adahaiajakalamajanaoab
adapaqarararararasatab
adadauadadavadadauadad
adawaxayadarazaAazaBab
acaCaDayadarazazaraEac
acaDaDaDadarazazaraEac
adaFaGaDadararararaEab
adacacaHadaIadadaIadad
aJararararararararaKab
adaLaraMaMaraMaMaraLab
ababaraMaMaraMaMarabab
aaacaraMaMaraMaMaracaa
ababaraMaMaraMaMarabab
adaLaraMaMaraMaMaraLab
aNararararararararaKab
adaOaraMaMadaMaMaraPab
adadaQauadadadauaRadab
adaSaTaTaUadaVaWaXaYab
adaZaTaTbaadbbaXaXaYab
adadbcadadadbdbebfbgab
adaTaTaTbhadaVaXaXaYab
adbibjbkadadadbbaXaYab
adblblblabaaabblblblab
abbmbmbmabaaabbmbmbmab
"}
