"aa" = (/turf/open/space,/area/space)
"ab" = (/turf/closed/wall/shuttle/smooth,/area/shuttle/escape)
"ac" = (/obj/structure/grille,/obj/structure/window/shuttle,/turf/open/floor/plating/airless,/area/shuttle/escape)
"ad" = (/turf/closed/wall/shuttle/smooth/nodiagonal,/area/shuttle/escape)
"ae" = (/obj/machinery/computer/communications,/turf/open/floor/plasteel/shuttle,/area/shuttle/escape)
"af" = (/obj/machinery/computer/crew,/turf/open/floor/plasteel/shuttle,/area/shuttle/escape)
"ag" = (/obj/machinery/computer/emergency_shuttle,/turf/open/floor/plasteel/shuttle,/area/shuttle/escape)
"ah" = (/obj/machinery/computer/station_alert,/turf/open/floor/plasteel/shuttle,/area/shuttle/escape)
"ai" = (/obj/structure/chair{tag = "icon-chair_shuttle (WEST)"; icon_state = "chair_shuttle"; dir = 8},/turf/open/floor/plasteel/shuttle/yellow,/area/shuttle/escape)
"aj" = (/obj/structure/chair{tag = "icon-chair_shuttle (NORTH)"; icon_state = "chair_shuttle"; dir = 1},/turf/open/floor/plasteel/shuttle/yellow,/area/shuttle/escape)
"ak" = (/obj/structure/table,/obj/item/weapon/storage/firstaid/regular,/turf/open/floor/plasteel/shuttle,/area/shuttle/escape)
"al" = (/obj/structure/table,/obj/item/weapon/storage/firstaid/toxin,/turf/open/floor/plasteel/shuttle,/area/shuttle/escape)
"am" = (/obj/structure/table,/obj/item/weapon/storage/firstaid/fire,/turf/open/floor/plasteel/shuttle,/area/shuttle/escape)
"an" = (/obj/structure/chair{tag = "icon-chair_shuttle (EAST)"; icon_state = "chair_shuttle"; dir = 4},/turf/open/floor/plasteel/shuttle/yellow,/area/shuttle/escape)
"ao" = (/obj/machinery/computer/secure_data,/turf/open/floor/plasteel/shuttle,/area/shuttle/escape)
"ap" = (/obj/machinery/computer/robotics,/turf/open/floor/plasteel/shuttle,/area/shuttle/escape)
"aq" = (/obj/structure/chair{tag = "icon-chair_shuttle (WEST)"; icon_state = "chair_shuttle"; dir = 8},/obj/machinery/light,/turf/open/floor/plasteel/shuttle/yellow,/area/shuttle/escape)
"ar" = (/turf/open/floor/plasteel/shuttle/yellow,/area/shuttle/escape)
"as" = (/obj/structure/chair{tag = "icon-chair_shuttle (EAST)"; icon_state = "chair_shuttle"; dir = 4},/obj/machinery/light,/turf/open/floor/plasteel/shuttle/yellow,/area/shuttle/escape)
"at" = (/obj/machinery/computer/card,/turf/open/floor/plasteel/shuttle,/area/shuttle/escape)
"au" = (/obj/machinery/door/airlock/glass_command{name = "Escape Shuttle Cockpit"; req_access_txt = "19"},/turf/open/floor/plasteel/shuttle/yellow,/area/shuttle/escape)
"av" = (/obj/structure/table,/obj/item/weapon/storage/firstaid/o2,/obj/item/weapon/storage/firstaid/toxin,/turf/open/floor/plasteel/shuttle/white,/area/shuttle/escape)
"aw" = (/obj/machinery/light{dir = 1},/turf/open/floor/plasteel/shuttle/white,/area/shuttle/escape)
"ax" = (/obj/structure/chair{tag = "icon-chair_shuttle (WEST)"; icon_state = "chair_shuttle"; dir = 8},/turf/open/floor/plasteel/shuttle/white,/area/shuttle/escape)
"ay" = (/obj/structure/chair{tag = "icon-chair_shuttle"; icon_state = "chair_shuttle"},/turf/open/floor/plasteel/shuttle,/area/shuttle/escape)
"az" = (/obj/structure/flora/kirbyplants{tag = "icon-plant-10"; icon_state = "plant-10"},/obj/structure/window/reinforced{dir = 8},/turf/open/floor/plasteel/shuttle,/area/shuttle/escape)
"aA" = (/obj/structure/flora/kirbyplants{tag = "icon-plant-10"; icon_state = "plant-10"},/obj/machinery/light{dir = 1},/turf/open/floor/plasteel/shuttle,/area/shuttle/escape)
"aB" = (/obj/structure/table,/obj/item/weapon/storage/firstaid/brute,/obj/item/weapon/storage/firstaid/fire,/turf/open/floor/plasteel/shuttle/white,/area/shuttle/escape)
"aC" = (/turf/open/floor/plasteel/shuttle/white,/area/shuttle/escape)
"aD" = (/obj/structure/chair{tag = "icon-chair_shuttle (WEST)"; icon_state = "chair_shuttle"; dir = 8},/turf/open/floor/plasteel/shuttle,/area/shuttle/escape)
"aE" = (/obj/machinery/sleeper{icon_state = "sleeper-open"; dir = 4},/turf/open/floor/plasteel/shuttle/white,/area/shuttle/escape)
"aF" = (/obj/machinery/light,/turf/open/floor/plasteel/shuttle/white,/area/shuttle/escape)
"aG" = (/obj/machinery/door/airlock/glass_virology{name = "Escape Shuttle Infirmary"},/turf/open/floor/plasteel/shuttle/white,/area/shuttle/escape)
"aH" = (/obj/machinery/door/airlock/glass,/turf/open/floor/plasteel/shuttle/yellow,/area/shuttle/escape)
"aI" = (/obj/machinery/door/airlock/shuttle,/obj/docking_port/mobile/emergency{dwidth = 10; timid = 1; width = 26},/turf/open/floor/plasteel/shuttle/yellow,/area/shuttle/escape)
"aJ" = (/obj/structure/table,/turf/open/floor/plasteel/shuttle,/area/shuttle/escape)
"aK" = (/obj/structure/closet/emcloset,/turf/open/floor/plasteel/shuttle,/area/shuttle/escape)
"aL" = (/obj/structure/chair{tag = "icon-chair_shuttle (NORTH)"; icon_state = "chair_shuttle"; dir = 1},/turf/open/floor/plasteel/shuttle,/area/shuttle/escape)
"aM" = (/obj/machinery/door/airlock/shuttle,/turf/open/floor/plasteel/shuttle/yellow,/area/shuttle/escape)
"aN" = (/obj/structure/chair{tag = "icon-chair_shuttle (EAST)"; icon_state = "chair_shuttle"; dir = 4},/obj/machinery/light{dir = 8},/turf/open/floor/plasteel/shuttle,/area/shuttle/escape)
"aO" = (/obj/structure/chair{tag = "icon-chair_shuttle (WEST)"; icon_state = "chair_shuttle"; dir = 8},/obj/machinery/light{icon_state = "tube1"; dir = 4},/turf/open/floor/plasteel/shuttle,/area/shuttle/escape)
"aP" = (/obj/machinery/door/airlock/maintenance_hatch,/turf/open/floor/plating,/area/shuttle/escape)
"aQ" = (/obj/machinery/door/airlock/glass_security{name = "Escape Shuttle Brig"; req_access_txt = "2"},/turf/open/floor/plasteel/shuttle/red,/area/shuttle/escape)
"aR" = (/obj/structure/reagent_dispensers/watertank,/turf/open/floor/plating,/area/shuttle/escape)
"aS" = (/turf/open/floor/plating,/area/shuttle/escape)
"aT" = (/obj/structure/table,/obj/item/weapon/storage/toolbox,/obj/machinery/light/small{dir = 4},/turf/open/floor/plating,/area/shuttle/escape)
"aU" = (/obj/structure/table,/turf/open/floor/plasteel/shuttle/red,/area/shuttle/escape)
"aV" = (/obj/structure/chair{tag = "icon-chair_shuttle"; icon_state = "chair_shuttle"},/turf/open/floor/plasteel/shuttle/red,/area/shuttle/escape)
"aW" = (/turf/open/floor/plasteel/shuttle/red,/area/shuttle/escape)
"aX" = (/obj/structure/chair{tag = "icon-chair_shuttle (WEST)"; icon_state = "chair_shuttle"; dir = 8},/turf/open/floor/plasteel/shuttle/red,/area/shuttle/escape)
"aY" = (/obj/machinery/light/small{dir = 8},/turf/open/floor/plating,/area/shuttle/escape)
"aZ" = (/obj/structure/table,/obj/item/weapon/extinguisher,/turf/open/floor/plating,/area/shuttle/escape)
"ba" = (/obj/structure/chair{tag = "icon-chair_shuttle (EAST)"; icon_state = "chair_shuttle"; dir = 4},/turf/open/floor/plasteel/shuttle/red,/area/shuttle/escape)
"bb" = (/obj/machinery/door/airlock/glass_engineering{name = "Engineering Hatch"},/turf/open/floor/plating,/area/shuttle/escape)
"bc" = (/obj/structure/window/reinforced,/obj/structure/chair{tag = "icon-chair_shuttle (EAST)"; icon_state = "chair_shuttle"; dir = 4},/obj/machinery/light{dir = 8},/turf/open/floor/plasteel/shuttle/red,/area/shuttle/escape)
"bd" = (/obj/structure/window/reinforced,/turf/open/floor/plasteel/shuttle/red,/area/shuttle/escape)
"be" = (/obj/machinery/door/window/brigdoor,/turf/open/floor/plasteel/shuttle/red,/area/shuttle/escape)
"bf" = (/obj/structure/window/reinforced,/obj/machinery/light{icon_state = "tube1"; dir = 4},/turf/open/floor/plasteel/shuttle/red,/area/shuttle/escape)
"bg" = (/obj/structure/closet/toolcloset,/turf/open/floor/plating,/area/shuttle/escape)
"bh" = (/obj/machinery/portable_atmospherics/canister/oxygen,/turf/open/floor/plating,/area/shuttle/escape)
"bi" = (/obj/machinery/portable_atmospherics/canister/air,/obj/machinery/light/small{dir = 1},/turf/open/floor/plating,/area/shuttle/escape)
"bj" = (/obj/machinery/portable_atmospherics/canister/air,/turf/open/floor/plating,/area/shuttle/escape)
"bk" = (/obj/structure/window/reinforced{dir = 1},/obj/structure/shuttle/engine/heater,/turf/open/floor/plating/airless,/area/shuttle/escape)
"bl" = (/obj/structure/shuttle/engine/propulsion,/turf/open/floor/plating/airless,/area/shuttle/escape)

(1,1,1) = {"
aaabacacabaaabacacabaa
abadaeafadadadagaeabab
adahaiajakalamajanaoab
adapaqarararararasatab
adadadadadauadadadadad
adavawaxadarayazayaAab
acaBaCaxadarayayaraDac
acaCaCaCadarayayaraDac
adaEaFaCadararararaDab
adacacaGadaHadadaHadad
aIararararararararaJab
adaKaraLaLaraLaLaraKab
ababaraLaLaraLaLarabab
aaacaraLaLaraLaLaracaa
ababaraLaLaraLaLarabab
adaKaraLaLaraLaLaraKab
aMararararararararaJab
adaNaraLaLadaLaLaraOab
adadaPadadadadadaQadab
adaRaSaSaTadaUaVaWaXab
adaYaSaSaZadbaaWaWaXab
adadbbadadadbcbdbebfab
adaSaSaSbgadaUaWaWaXab
adbhbibjadadadbaaWaXab
adbkbkbkabaaabbkbkbkab
abblblblabaaabblblblab
"}
