//MAP CONVERTED BY dmm2tgm.py THIS HEADER COMMENT PREVENTS RECONVERSION, DO NOT REMOVE 
"aa" = (
/turf/open/space,
/area/space)
"ab" = (
/turf/open/space,
/turf/closed/wall/shuttle{
	tag = "icon-wall3 (NORTHWEST)";
	icon_state = "wall3";
	dir = 9
	},
/area/shuttle/escape)
"ac" = (
/obj/structure/window/reinforced,
/obj/structure/window/reinforced{
	dir = 1
	},
/obj/structure/grille,
/turf/open/floor/plating,
/area/shuttle/escape)
"ad" = (
/turf/open/space,
/turf/closed/wall/shuttle{
	tag = "icon-wall3 (NORTHEAST)";
	icon_state = "wall3";
	dir = 5
	},
/area/shuttle/escape)
"ae" = (
/turf/closed/wall/shuttle{
	icon_state = "wall3"
	},
/area/shuttle/escape)
"af" = (
/obj/structure/table,
/turf/open/floor/plasteel/darkred/side{
	tag = "icon-darkred (NORTH)";
	icon_state = "darkred";
	dir = 1
	},
/area/shuttle/escape)
"ag" = (
/obj/structure/chair{
	dir = 1
	},
/turf/open/floor/plasteel/darkred/side{
	tag = "icon-darkred (NORTH)";
	icon_state = "darkred";
	dir = 1
	},
/area/shuttle/escape)
"ah" = (
/obj/machinery/computer/emergency_shuttle,
/turf/open/floor/plasteel/darkred/side{
	tag = "icon-darkred (NORTH)";
	icon_state = "darkred";
	dir = 1
	},
/area/shuttle/escape)
"ai" = (
/obj/structure/table,
/obj/item/weapon/storage/firstaid/regular,
/obj/item/weapon/storage/firstaid/fire{
	pixel_x = 4
	},
/turf/open/floor/plasteel/darkred/side{
	tag = "icon-darkred (NORTH)";
	icon_state = "darkred";
	dir = 1
	},
/area/shuttle/escape)
"aj" = (
/obj/item/weapon/banner/fascist/alt,
/turf/open/floor/plasteel/shuttle/red,
/area/shuttle/escape)
"ak" = (
/obj/machinery/computer/atmos_alert,
/turf/open/floor/plasteel/darkred/side{
	tag = "icon-darkred (WEST)";
	icon_state = "darkred";
	dir = 8
	},
/area/shuttle/escape)
"al" = (
/obj/structure/chair{
	dir = 8
	},
/turf/open/floor/plasteel/circuit/gcircuit/off,
/area/shuttle/escape)
"am" = (
/turf/open/floor/plasteel/circuit/gcircuit/off,
/area/shuttle/escape)
"an" = (
/obj/structure/chair/comfy/lime{
	dir = 1
	},
/turf/open/floor/plasteel/circuit/gcircuit/off,
/area/shuttle/escape)
"ao" = (
/obj/structure/chair{
	dir = 4
	},
/turf/open/floor/plasteel/circuit/gcircuit/off,
/area/shuttle/escape)
"ap" = (
/obj/machinery/computer/security,
/turf/open/floor/plasteel/darkred/side{
	tag = "icon-darkred (EAST)";
	icon_state = "darkred";
	dir = 4
	},
/area/shuttle/escape)
"aq" = (
/obj/item/weapon/banner/fascist,
/turf/closed/wall/shuttle{
	icon_state = "wall3"
	},
/area/shuttle/escape)
"ar" = (
/obj/machinery/computer/crew,
/turf/open/floor/plasteel/darkred/side{
	tag = "icon-darkred (WEST)";
	icon_state = "darkred";
	dir = 8
	},
/area/shuttle/escape)
"as" = (
/obj/structure/chair{
	dir = 8
	},
/obj/structure/extinguisher_cabinet{
	pixel_y = -30
	},
/turf/open/floor/plasteel/circuit/gcircuit/off,
/area/shuttle/escape)
"at" = (
/obj/machinery/button/flasher{
	id = "cockpit_flasher";
	pixel_y = -24
	},
/turf/open/floor/plasteel/circuit/gcircuit/off,
/area/shuttle/escape)
"au" = (
/obj/machinery/computer/communications,
/turf/open/floor/plasteel/darkred/side{
	tag = "icon-darkred (EAST)";
	icon_state = "darkred";
	dir = 4
	},
/area/shuttle/escape)
"av" = (
/obj/structure/window/reinforced{
	dir = 1
	},
/obj/structure/window/reinforced,
/obj/structure/grille,
/turf/open/floor/plating,
/area/shuttle/escape)
"aw" = (
/obj/item/weapon/banner/fascist/alt,
/turf/open/floor/plasteel/black,
/area/shuttle/escape)
"ax" = (
/obj/structure/extinguisher_cabinet{
	pixel_x = 24
	},
/obj/machinery/atmospherics/components/unary/portables_connector/visible,
/turf/open/floor/plasteel/black,
/area/shuttle/escape)
"ay" = (
/turf/open/floor/plasteel/darkred/side,
/area/shuttle/escape)
"az" = (
/obj/machinery/door/airlock/centcom{
	req_access_txt = "19"
	},
/turf/open/floor/plasteel/black,
/area/shuttle/escape)
"aA" = (
/obj/machinery/status_display,
/turf/closed/wall/shuttle{
	icon_state = "wall3"
	},
/area/shuttle/escape)
"aB" = (
/obj/machinery/sleeper{
	icon_state = "sleeper-open";
	dir = 8
	},
/turf/open/floor/plasteel/black,
/area/shuttle/escape)
"aC" = (
/obj/structure/chair,
/turf/open/floor/plasteel/shuttle/red,
/area/shuttle/escape)
"aD" = (
/obj/machinery/flasher{
	id = "shuttlebrig";
	pixel_y = 24
	},
/turf/open/floor/plasteel/shuttle/red,
/area/shuttle/escape)
"aE" = (
/obj/structure/chair{
	dir = 8
	},
/turf/open/floor/plasteel/shuttle/red,
/area/shuttle/escape)
"aF" = (
/obj/machinery/flasher{
	id = "cockpit_flasher";
	pixel_y = 24
	},
/turf/open/floor/plasteel/darkred/side{
	tag = "icon-darkred (NORTH)";
	icon_state = "darkred";
	dir = 1
	},
/area/shuttle/escape)
"aG" = (
/turf/open/floor/plasteel/black,
/area/shuttle/escape)
"aH" = (
/obj/structure/extinguisher_cabinet{
	pixel_y = 30
	},
/turf/open/floor/plasteel/black,
/area/shuttle/escape)
"aI" = (
/obj/structure/closet/emcloset,
/turf/open/floor/plasteel/black,
/area/shuttle/escape)
"aJ" = (
/turf/open/floor/plasteel/shuttle/red,
/area/shuttle/escape)
"aK" = (
/obj/structure/chair{
	dir = 1
	},
/turf/open/floor/plasteel/shuttle/red,
/area/shuttle/escape)
"aL" = (
/obj/structure/chair,
/turf/open/floor/plasteel/darkred/side,
/area/shuttle/escape)
"aM" = (
/obj/structure/chair{
	dir = 8
	},
/turf/open/floor/plasteel/darkred/side{
	tag = "icon-darkred (EAST)";
	icon_state = "darkred";
	dir = 4
	},
/area/shuttle/escape)
"aN" = (
/obj/structure/grille,
/obj/structure/window/reinforced,
/obj/structure/window/reinforced{
	dir = 1
	},
/turf/open/floor/plasteel/shuttle/red,
/area/shuttle/escape)
"aO" = (
/obj/machinery/door/airlock/centcom{
	req_access_txt = "2"
	},
/turf/open/floor/plasteel/shuttle/red,
/area/shuttle/escape)
"aP" = (
/obj/structure/chair,
/obj/machinery/button/flasher{
	id = "shuttlebrig";
	pixel_x = -22;
	req_access_txt = "2"
	},
/turf/open/floor/plasteel/shuttle/red,
/area/shuttle/escape)
"aQ" = (
/obj/structure/window/reinforced,
/obj/structure/window/reinforced{
	dir = 1
	},
/obj/structure/window/reinforced{
	dir = 4
	},
/obj/structure/window/reinforced{
	dir = 8
	},
/obj/structure/grille,
/turf/open/floor/plating,
/area/shuttle/escape)
"aR" = (
/obj/structure/extinguisher_cabinet{
	pixel_y = -30
	},
/turf/open/floor/plasteel/shuttle/red,
/area/shuttle/escape)
"aS" = (
/obj/structure/closet,
/turf/open/floor/plasteel/black,
/area/shuttle/escape)
"aT" = (
/obj/structure/window/reinforced,
/obj/structure/chair{
	dir = 1
	},
/turf/open/floor/plasteel/darkred/side,
/area/shuttle/escape)
"aU" = (
/obj/machinery/door/airlock/centcom{
	req_access_txt = "2"
	},
/turf/open/floor/plasteel/shuttle,
/area/shuttle/escape)
"aV" = (
/obj/structure/window/reinforced{
	dir = 1
	},
/obj/structure/chair,
/turf/open/floor/plasteel/darkred/side{
	tag = "icon-darkred (NORTH)";
	icon_state = "darkred";
	dir = 1
	},
/area/shuttle/escape)
"aW" = (
/obj/docking_port/mobile/emergency{
	dwidth = 12;
	height = 13;
	name = "The Undying Classic";
	timid = 1;
	width = 27
	},
/obj/machinery/door/airlock/centcom,
/turf/open/floor/plasteel/shuttle,
/area/shuttle/escape)
"aX" = (
/obj/structure/extinguisher_cabinet{
	pixel_x = 24
	},
/turf/open/floor/plasteel/black,
/area/shuttle/escape)
"aY" = (
/obj/structure/chair{
	dir = 4
	},
/turf/open/floor/plasteel/darkred/side{
	tag = "icon-darkred (WEST)";
	icon_state = "darkred";
	dir = 8
	},
/area/shuttle/escape)
"aZ" = (
/obj/machinery/door/airlock/centcom,
/turf/open/floor/plasteel/shuttle,
/area/shuttle/escape)
"ba" = (
/obj/machinery/door/airlock/glass_large,
/turf/open/floor/plasteel/black,
/area/shuttle/escape)
"bb" = (
/obj/structure/bodycontainer/morgue,
/turf/open/floor/plasteel/darkred/side,
/area/shuttle/escape)
"bc" = (
/obj/structure/window/reinforced{
	dir = 1
	},
/obj/structure/window/reinforced{
	dir = 8
	},
/turf/open/floor/plasteel/circuit/gcircuit/off,
/area/shuttle/escape)
"bd" = (
/obj/machinery/door/window/northright,
/turf/open/floor/plasteel/circuit/gcircuit/off,
/area/shuttle/escape)
"be" = (
/obj/structure/window/reinforced{
	dir = 1
	},
/obj/machinery/atmospherics/components/unary/outlet_injector{
	tag = "icon-inje_map (NORTH)";
	icon_state = "inje_map";
	dir = 1
	},
/turf/open/floor/plasteel/circuit/gcircuit/off,
/area/shuttle/escape)
"bf" = (
/obj/machinery/door/airlock/centcom,
/turf/open/floor/plasteel/shuttle/white,
/area/shuttle/escape)
"bg" = (
/obj/machinery/sleeper{
	icon_state = "sleeper-open";
	dir = 8
	},
/turf/open/floor/plasteel/darkred/side{
	tag = "icon-darkred (NORTH)";
	icon_state = "darkred";
	dir = 1
	},
/area/shuttle/escape)
"bh" = (
/obj/structure/window/reinforced{
	dir = 8
	},
/turf/open/floor/plasteel/circuit/gcircuit/off,
/area/shuttle/escape)
"bi" = (
/obj/structure/bed,
/obj/structure/bed{
	layer = 4.5;
	pixel_y = 10
	},
/turf/open/floor/plasteel/circuit/gcircuit/off,
/area/shuttle/escape)
"bj" = (
/obj/structure/table,
/obj/item/weapon/reagent_containers/blood/random,
/obj/item/weapon/reagent_containers/blood/random,
/obj/item/weapon/reagent_containers/blood/random,
/turf/open/floor/plasteel/black,
/area/shuttle/escape)
"bk" = (
/obj/structure/closet,
/turf/open/floor/plasteel/darkred/side{
	tag = "icon-darkred (WEST)";
	icon_state = "darkred";
	dir = 8
	},
/area/shuttle/escape)
"bl" = (
/obj/structure/bodycontainer/morgue,
/turf/open/floor/plasteel/black,
/area/shuttle/escape)
"bm" = (
/obj/machinery/iv_drip,
/turf/open/floor/plasteel/black,
/area/shuttle/escape)
"bn" = (
/turf/open/floor/plasteel/darkred/side{
	tag = "icon-darkred (WEST)";
	icon_state = "darkred";
	dir = 8
	},
/area/shuttle/escape)
"bo" = (
/obj/machinery/vending/cola,
/turf/open/floor/plasteel/darkred/side{
	tag = "icon-darkred (NORTH)";
	icon_state = "darkred";
	dir = 1
	},
/area/shuttle/escape)
"bp" = (
/obj/machinery/vending/snack,
/turf/open/floor/plasteel/darkred/side{
	tag = "icon-darkred (NORTH)";
	icon_state = "darkred";
	dir = 1
	},
/area/shuttle/escape)
"bq" = (
/obj/structure/closet/crate,
/turf/open/floor/plasteel/darkred/side{
	tag = "icon-darkred (WEST)";
	icon_state = "darkred";
	dir = 8
	},
/area/shuttle/escape)
"br" = (
/turf/open/space,
/turf/closed/wall/shuttle{
	icon_state = "swall_f5";
	dir = 2
	},
/turf/closed/wall/shuttle{
	dir = 2;
	icon_state = "diagonalWall3"
	},
/area/shuttle/escape)
"bs" = (
/obj/machinery/sleeper{
	icon_state = "sleeper-open";
	dir = 8
	},
/turf/open/floor/plasteel/darkred/side,
/area/shuttle/escape)
"bt" = (
/turf/open/space,
/turf/closed/wall/shuttle{
	icon_state = "swall_f9";
	dir = 2
	},
/turf/closed/wall/shuttle{
	dir = 4;
	icon_state = "diagonalWall3"
	},
/area/shuttle/escape)
"bu" = (
/obj/structure/shuttle/engine/propulsion,
/turf/open/floor/plating/airless,
/area/shuttle/escape)
"bv" = (
/obj/structure/closet/crate,
/turf/open/floor/plasteel/black,
/area/shuttle/escape)
"bA" = (
/obj/structure/table,
/turf/open/floor/plasteel/black,
/area/shuttle/escape)
"bz" = (
/obj/structure/window/reinforced{
	dir = 8
	},
/obj/structure/window/reinforced{
	dir = 4
	},
/obj/structure/grille,
/turf/open/floor/plating,
/area/shuttle/escape)
"by" = (
/obj/structure/table,
/obj/item/weapon/storage/firstaid/regular,
/obj/item/weapon/storage/firstaid/fire{
	pixel_x = 4
	},
/turf/open/floor/plasteel/black,
/area/shuttle/escape)
"bx" = (
/turf/open/floor/plasteel/darkred/side{
	tag = "icon-darkred (NORTH)";
	icon_state = "darkred";
	dir = 1
	},
/area/shuttle/escape)
"bw" = (
/obj/structure/window/reinforced{
	dir = 4
	},
/obj/structure/window/reinforced{
	dir = 8
	},
/obj/structure/grille,
/turf/open/floor/plating,
/area/shuttle/escape)

(1,1,1) = {"
aa
aa
aa
aa
ab
aq
bz
aq
ae
ae
aO
ae
aW
aq
bw
bw
bw
aq
aZ
ae
bf
ae
bz
aq
ae
br
aa
"}
(2,1,1) = {"
aa
aa
aa
ab
ae
aC
aJ
aK
aN
aP
aJ
ae
aG
aY
aY
aY
aY
aY
aG
av
bx
aI
aI
bl
bb
ae
br
"}
(3,1,1) = {"
aa
ab
bw
aq
ae
aC
aJ
aK
aN
aC
am
av
aG
aG
aG
aG
aG
aG
aG
ba
bx
aG
aG
aG
ay
av
bu
"}
(4,1,1) = {"
ab
ae
ak
ar
ae
aD
aJ
aJ
aO
aJ
am
av
aG
aT
aV
aG
aT
aV
aG
aG
bx
aG
bj
bm
ay
av
bu
"}
(5,1,1) = {"
ac
af
al
as
ae
aE
aE
aE
aN
aj
aR
ae
aG
aT
aV
aG
aT
aV
aG
av
bx
aG
aG
aG
ay
av
bu
"}
(6,1,1) = {"
ac
ag
am
am
ae
aq
bz
aq
ae
bz
aO
aA
aG
aT
aV
aG
aT
aV
aG
ae
bg
aB
by
aB
bs
av
bu
"}
(7,1,1) = {"
ac
ah
an
at
ae
aF
aG
aL
bA
aG
aG
aG
aG
aG
aG
aw
aG
aG
aG
aA
ae
ae
aQ
ae
ae
aq
ae
"}
(8,1,1) = {"
ac
ag
am
am
az
bx
aG
aL
bA
aG
aT
aV
aG
aT
aV
aG
aT
aV
aG
ay
aG
aG
aG
aG
bo
av
bu
"}
(9,1,1) = {"
ac
ai
ao
ao
aA
bx
aG
aL
bA
aG
aT
aV
aG
aT
aV
aG
aT
aV
aG
ay
aG
aG
aX
aG
bp
av
bu
"}
(10,1,1) = {"
ad
ae
ap
au
ae
aH
aG
bA
bA
aG
aT
aV
aG
aT
aV
aG
aT
aV
aG
bc
bh
ae
ae
aU
ae
av
bu
"}
(11,1,1) = {"
aa
ad
bw
aq
ae
aI
aG
aG
aG
aG
aG
aG
aG
aG
aG
aG
aG
aG
aG
bd
am
ae
bk
bn
bq
av
bu
"}
(12,1,1) = {"
aa
aa
aa
ad
ae
by
aG
aM
aM
aM
aM
aM
aX
aM
aG
aG
aG
aM
ax
be
bi
ae
aS
aG
bv
ae
bt
"}
(13,1,1) = {"
aa
aa
aa
aa
ad
ae
bz
aq
ae
ae
bz
ae
ae
aq
bw
bw
bw
aq
ae
ae
bz
ae
bz
aq
ae
bt
aa
"}
