"aa" = (/turf/open/space,/area/space)
"ab" = (/turf/open/space,/turf/closed/wall/shuttle{tag = "icon-wall3 (NORTHWEST)"; icon_state = "wall3"; dir = 9},/area/shuttle/escape)
"ac" = (/turf/closed/wall/shuttle{icon = 'icons/turf/walls.dmi'; icon_state = "wall3"},/area/shuttle/escape)
"ad" = (/obj/structure/grille,/obj/machinery/door/poddoor/shutters{id = "syndieshutters2"; name = "blast shutters"},/obj/structure/window/reinforced/fulltile,/turf/open/floor/plating,/area/shuttle/escape)
"ae" = (/turf/open/space,/turf/closed/wall/shuttle{tag = "icon-wall3 (NORTHEAST)"; icon_state = "wall3"; dir = 5},/area/shuttle/escape)
"af" = (/obj/structure/table,/obj/machinery/microwave,/turf/open/floor/plasteel/shuttle{icon_state = "shuttlefloor4"},/area/shuttle/escape)
"ag" = (/obj/structure/table,/obj/item/device/flashlight/lamp{pixel_x = 4; pixel_y = 1},/turf/open/floor/plasteel/shuttle{icon_state = "shuttlefloor4"},/area/shuttle/escape)
"ah" = (/obj/machinery/computer/communications,/turf/open/floor/plasteel/shuttle{icon_state = "shuttlefloor4"},/area/shuttle/escape)
"ai" = (/obj/machinery/computer/emergency_shuttle,/turf/open/floor/plasteel/shuttle{icon_state = "shuttlefloor4"},/area/shuttle/escape)
"aj" = (/obj/structure/table,/obj/machinery/button/door{id = "syndieshutters2"; name = "remote shutter control"; req_access_txt = "150"},/turf/open/floor/plasteel/shuttle{icon_state = "shuttlefloor4"},/area/shuttle/escape)
"ak" = (/obj/structure/frame/computer,/turf/open/floor/plasteel/shuttle{icon_state = "shuttlefloor4"},/area/shuttle/escape)
"al" = (/obj/structure/table,/obj/item/weapon/storage/box/donkpockets{pixel_x = 3; pixel_y = 3},/turf/open/floor/plasteel/shuttle{icon_state = "shuttlefloor4"},/area/shuttle/escape)
"am" = (/turf/open/floor/plasteel/shuttle{icon_state = "shuttlefloor4"},/area/shuttle/escape)
"an" = (/obj/structure/chair/comfy/beige{dir = 1; icon_state = "comfychair"},/turf/open/floor/plasteel/shuttle{icon_state = "shuttlefloor4"},/area/shuttle/escape)
"ao" = (/obj/structure/table,/obj/item/stack/sheet/glass{amount = 10},/obj/item/device/multitool,/turf/open/floor/plasteel/shuttle{icon_state = "shuttlefloor4"},/area/shuttle/escape)
"ap" = (/obj/item/device/radio/intercom{desc = "Talk through this. Evilly"; freerange = 1; frequency = 1213; name = "Syndicate Intercom"; pixel_y = -32; subspace_transmission = 1; syndie = 1},/turf/open/floor/plasteel/shuttle{icon_state = "shuttlefloor4"},/area/shuttle/escape)
"aq" = (/obj/structure/closet/syndicate/personal,/turf/open/floor/plasteel/shuttle{icon_state = "shuttlefloor4"},/area/shuttle/escape)
"ar" = (/turf/open/space,/turf/closed/wall/shuttle{tag = "icon-wall3 (SOUTHWEST)"; icon_state = "wall3"; dir = 10},/area/shuttle/escape)
"as" = (/obj/machinery/door/window{name = "Cockpit"; req_access_txt = "0"},/turf/open/floor/plasteel/shuttle{icon_state = "shuttlefloor4"},/area/shuttle/escape)
"at" = (/turf/open/space,/turf/closed/wall/shuttle{tag = "icon-wall3 (SOUTHEAST)"; icon_state = "wall3"; dir = 6},/area/shuttle/escape)
"au" = (/obj/structure/table,/obj/item/stack/cable_coil,/obj/item/weapon/crowbar/red,/turf/open/floor/plasteel/shuttle{icon_state = "shuttlefloor4"},/area/shuttle/escape)
"av" = (/obj/structure/table,/obj/item/weapon/storage/box/zipties{pixel_x = 1; pixel_y = 2},/turf/open/floor/plasteel/shuttle{icon_state = "shuttlefloor4"},/area/shuttle/escape)
"aw" = (/obj/structure/chair{dir = 8},/turf/open/floor/plasteel/shuttle{icon_state = "shuttlefloor4"},/area/shuttle/escape)
"ax" = (/obj/structure/closet/syndicate/nuclear,/turf/open/floor/plasteel/shuttle{icon_state = "shuttlefloor4"},/area/shuttle/escape)
"ay" = (/obj/machinery/suit_storage_unit/syndicate,/turf/open/floor/plasteel/shuttle{icon_state = "shuttlefloor4"},/area/shuttle/escape)
"az" = (/turf/open/space,/turf/closed/wall/shuttle{dir = 8; icon_state = "diagonalWall3"},/area/shuttle/escape)
"aA" = (/obj/structure/table,/obj/item/device/aicard,/turf/open/floor/plasteel/shuttle{icon_state = "shuttlefloor4"},/area/shuttle/escape)
"aB" = (/obj/structure/chair/stool{pixel_y = 8},/turf/open/floor/plasteel/shuttle{icon_state = "shuttlefloor4"},/area/shuttle/escape)
"aC" = (/obj/structure/grille,/obj/structure/window/reinforced/fulltile,/turf/open/floor/plating,/area/shuttle/escape)
"aD" = (/obj/machinery/door/window{name = "Ready Room"; req_access_txt = "0"},/turf/open/floor/plasteel/shuttle{icon_state = "shuttlefloor4"},/area/shuttle/escape)
"aE" = (/obj/structure/table,/obj/item/weapon/c4{pixel_x = -2; pixel_y = -1},/obj/item/weapon/c4{pixel_x = -2; pixel_y = -1},/obj/item/weapon/c4{pixel_x = -2; pixel_y = -1},/obj/item/weapon/c4{pixel_x = -2; pixel_y = -1},/obj/item/weapon/c4{pixel_x = -2; pixel_y = -1},/turf/open/floor/plasteel/shuttle{icon_state = "shuttlefloor4"},/area/shuttle/escape)
"aF" = (/obj/machinery/door/airlock/external,/obj/docking_port/mobile/emergency{dheight = 1; dwidth = 11; height = 17; timid = 1; width = 23},/turf/open/floor/plasteel/shuttle{icon_state = "shuttlefloor4"},/area/shuttle/escape)
"aG" = (/obj/machinery/door/airlock/external,/turf/open/floor/plasteel/shuttle{icon_state = "shuttlefloor4"},/area/shuttle/escape)
"aH" = (/obj/machinery/door/window{base_state = "right"; dir = 8; icon_state = "right"; name = "EVA Storage"; req_access_txt = "0"; tag = "icon-right (WEST)"},/turf/open/floor/plasteel/shuttle{icon_state = "shuttlefloor4"},/area/shuttle/escape)
"aI" = (/obj/machinery/door/window{dir = 8; name = "EVA storage"; req_access_txt = "0"},/turf/open/floor/plasteel/shuttle{icon_state = "shuttlefloor4"},/area/shuttle/escape)
"aJ" = (/obj/item/device/radio/intercom{desc = "Talk through this. Evilly"; freerange = 1; frequency = 1213; name = "Syndicate Intercom"; pixel_x = -32; subspace_transmission = 1; syndie = 1},/turf/open/floor/plasteel/shuttle{icon_state = "shuttlefloor4"},/area/shuttle/escape)
"aK" = (/obj/machinery/sleeper/syndie{dir = 4},/turf/open/floor/plasteel/shuttle{icon_state = "shuttlefloor3"},/area/shuttle/escape)
"aL" = (/turf/open/floor/plasteel/shuttle{icon_state = "shuttlefloor3"},/area/shuttle/escape)
"aM" = (/obj/machinery/portable_atmospherics/canister/oxygen,/turf/open/floor/plasteel/shuttle{icon_state = "shuttlefloor3"},/area/shuttle/escape)
"aN" = (/obj/structure/tank_dispenser/oxygen,/turf/open/floor/plasteel/shuttle{icon_state = "shuttlefloor3"},/area/shuttle/escape)
"aO" = (/obj/structure/table,/obj/item/stack/medical/ointment,/obj/item/stack/medical/bruise_pack,/obj/structure/extinguisher_cabinet{pixel_x = -5; pixel_y = 30},/turf/open/floor/plasteel/shuttle{icon_state = "shuttlefloor3"},/area/shuttle/escape)
"aP" = (/obj/structure/table,/obj/item/weapon/stock_parts/cell/high{pixel_x = -3; pixel_y = 3},/obj/item/weapon/stock_parts/cell/high,/turf/open/floor/plasteel/shuttle{icon_state = "shuttlefloor4"},/area/shuttle/escape)
"aQ" = (/obj/structure/table,/obj/item/weapon/screwdriver{pixel_y = 9},/obj/item/device/assembly/voice{pixel_y = 3},/turf/open/floor/plasteel/shuttle{icon_state = "shuttlefloor4"},/area/shuttle/escape)
"aR" = (/obj/structure/table,/obj/item/weapon/wrench,/obj/item/device/assembly/infra,/turf/open/floor/plasteel/shuttle{icon_state = "shuttlefloor4"},/area/shuttle/escape)
"aS" = (/obj/structure/table,/obj/item/device/assembly/signaler,/obj/item/device/assembly/signaler,/obj/item/device/assembly/prox_sensor{pixel_x = -8; pixel_y = 4},/obj/item/device/assembly/prox_sensor{pixel_x = -8; pixel_y = 4},/turf/open/floor/plasteel/shuttle{icon_state = "shuttlefloor4"},/area/shuttle/escape)
"aT" = (/obj/structure/table,/obj/item/weapon/weldingtool/largetank{pixel_y = 3},/obj/item/device/multitool,/turf/open/floor/plasteel/shuttle{icon_state = "shuttlefloor4"},/area/shuttle/escape)
"aU" = (/obj/structure/bed/roller,/turf/open/floor/plasteel/shuttle{icon_state = "shuttlefloor3"},/area/shuttle/escape)
"aV" = (/obj/structure/sign/bluecross_2,/turf/closed/wall/shuttle{icon = 'icons/turf/walls.dmi'; icon_state = "wall3"},/area/shuttle/escape)
"aW" = (/obj/structure/table,/obj/item/weapon/storage/toolbox/syndicate,/obj/item/weapon/crowbar/red,/turf/open/floor/plasteel/shuttle{icon_state = "shuttlefloor4"},/area/shuttle/escape)
"aX" = (/obj/machinery/door/window{dir = 4; name = "Infirmary"; req_access_txt = "0"},/turf/open/floor/plasteel/shuttle{icon_state = "shuttlefloor3"},/area/shuttle/escape)
"aY" = (/obj/machinery/door/window/westright{name = "Tool Storage"; req_access_txt = "0"},/turf/open/floor/plasteel/shuttle{icon_state = "shuttlefloor4"},/area/shuttle/escape)
"aZ" = (/obj/machinery/door/window{base_state = "right"; dir = 4; icon_state = "right"; name = "Infirmary"; req_access_txt = "0"},/turf/open/floor/plasteel/shuttle{icon_state = "shuttlefloor3"},/area/shuttle/escape)
"ba" = (/obj/machinery/door/window{dir = 8; name = "Tool Storage"; req_access_txt = "0"},/turf/open/floor/plasteel/shuttle{icon_state = "shuttlefloor4"},/area/shuttle/escape)
"bb" = (/obj/machinery/recharge_station,/turf/open/floor/plasteel/shuttle{icon_state = "shuttlefloor4"},/area/shuttle/escape)
"bc" = (/obj/structure/window/reinforced{dir = 1},/obj/structure/table,/obj/item/robot_parts/r_arm,/obj/item/robot_parts/l_arm,/turf/open/floor/plasteel/shuttle{icon_state = "shuttlefloor3"},/area/shuttle/escape)
"bd" = (/obj/machinery/door/window{dir = 1; name = "Surgery"; req_access_txt = "0"},/turf/open/floor/plasteel/shuttle{icon_state = "shuttlefloor3"},/area/shuttle/escape)
"be" = (/obj/structure/window/reinforced{dir = 1},/turf/open/floor/plasteel/shuttle{icon_state = "shuttlefloor3"},/area/shuttle/escape)
"bf" = (/obj/structure/table,/obj/structure/window/reinforced{dir = 8},/obj/item/weapon/storage/firstaid/regular{pixel_x = 3; pixel_y = 3},/obj/item/weapon/storage/firstaid/brute,/obj/item/weapon/storage/firstaid/toxin{pixel_x = -3; pixel_y = -3},/turf/open/floor/plasteel/shuttle{icon_state = "shuttlefloor3"},/area/shuttle/escape)
"bg" = (/obj/structure/table,/obj/item/weapon/storage/firstaid/regular{pixel_x = 3; pixel_y = 3},/obj/item/weapon/storage/firstaid/fire,/obj/item/weapon/storage/firstaid/regular{pixel_x = -3; pixel_y = -3},/turf/open/floor/plasteel/shuttle{icon_state = "shuttlefloor3"},/area/shuttle/escape)
"bh" = (/obj/structure/table,/obj/item/device/sbeacondrop/bomb{pixel_y = 5},/obj/item/device/sbeacondrop/bomb,/turf/open/floor/plasteel/shuttle{icon_state = "shuttlefloor4"},/area/shuttle/escape)
"bi" = (/obj/structure/table,/obj/item/weapon/grenade/syndieminibomb{pixel_x = 4; pixel_y = 2},/obj/item/weapon/grenade/syndieminibomb{pixel_x = -1},/turf/open/floor/plasteel/shuttle{icon_state = "shuttlefloor4"},/area/shuttle/escape)
"bj" = (/obj/structure/table,/obj/item/weapon/surgicaldrill,/obj/item/weapon/circular_saw,/turf/open/floor/plasteel/shuttle{icon_state = "shuttlefloor3"},/area/shuttle/escape)
"bk" = (/obj/structure/sink{dir = 4; icon_state = "sink"; pixel_x = 11; pixel_y = 0},/obj/structure/mirror{pixel_x = 30},/turf/open/floor/plasteel/shuttle{icon_state = "shuttlefloor3"},/area/shuttle/escape)
"bl" = (/obj/machinery/door/window{dir = 1; name = "Secure Storage"; req_access_txt = "0"},/obj/machinery/nuclearbomb,/turf/open/floor/plasteel/shuttle{icon_state = "shuttlefloor4"},/area/shuttle/escape)
"bm" = (/obj/structure/table,/obj/item/weapon/cautery,/obj/item/weapon/scalpel,/turf/open/floor/plasteel/shuttle{icon_state = "shuttlefloor3"},/area/shuttle/escape)
"bn" = (/obj/structure/table/optable,/obj/item/weapon/surgical_drapes,/turf/open/floor/plasteel/shuttle{icon_state = "shuttlefloor3"},/area/shuttle/escape)
"bo" = (/obj/structure/table,/obj/item/weapon/retractor,/obj/item/weapon/hemostat,/turf/open/floor/plasteel/shuttle{icon_state = "shuttlefloor3"},/area/shuttle/escape)
"bp" = (/obj/structure/shuttle/engine/heater,/obj/structure/window/reinforced{dir = 1},/turf/open/floor/plating,/area/shuttle/escape)
"bq" = (/obj/structure/reagent_dispensers/fueltank,/turf/open/floor/plasteel/shuttle{icon_state = "shuttlefloor4"},/area/shuttle/escape)
"br" = (/obj/structure/table,/obj/item/stack/sheet/metal{amount = 50},/obj/item/stack/sheet/glass{amount = 50},/obj/item/stack/rods{amount = 50},/turf/open/floor/plasteel/shuttle{icon_state = "shuttlefloor4"},/area/shuttle/escape)
"bs" = (/obj/structure/rack,/obj/item/clothing/suit/space/syndicate/black/red,/obj/item/clothing/head/helmet/space/syndicate/black/red,/turf/open/floor/plasteel/shuttle{icon_state = "shuttlefloor4"},/area/shuttle/escape)
"bt" = (/obj/structure/shuttle/engine/propulsion{icon_state = "propulsion_l"},/turf/open/floor/plating,/area/shuttle/escape)
"bu" = (/obj/structure/shuttle/engine/propulsion,/turf/open/floor/plating,/area/shuttle/escape)
"bv" = (/obj/structure/shuttle/engine/propulsion{icon_state = "propulsion_r"},/turf/open/floor/plating,/area/shuttle/escape)

(1,1,1) = {"
aaaaaaaaabacadadadadadacaeaaaaaaaa
aaaaaaaaacafagahaiajakakacaaaaaaaa
aaaaaaaaacalamananamamamacaaaaaaaa
aaaaaaaaacaoamamamapamaqacaaaaaaaa
aaaaaaaaaracacacasacacacataaaaaaaa
aaaaaaaaaaaracauamavacataaaaaaaaaa
aaaaaaaaaaaaacamamawacaaaaaaaaaaaa
aaaaaaaaaaaaacamamawacacacacacaeaa
aaaaaaaaaaaaacamamawacaxamamayacaa
aaazacacacacacamamawacaAaBamayacaa
aaacamamamamacaCaDaCacaEamamayacaa
aaaFamamamamaGamamamaHamamamayacaa
aaacamamamamaCamamamaIamamamayacaa
abacacacacacacaJamamacacacacacacae
acaKaLaMaNaOacamamamacaPaQaRaSaTac
acaUaLaLaLaLaVamamamacamamamaBaWac
acaKaLaLaLaLaXamamamaYamamamamamac
acaLaLaLaLaLaZamamambaamamamambbac
acbcbdbebfbgacamamamacbhbiamambbac
acbjaLbkacacacaCblaCacacacamamamac
acbmbnboacaaacbpbpbpacaaacbqbrbsac
acbpbpbpacaaarbtbubvataaacbpbpbpac
arbtbubvataaaaaaaaaaaaaaarbtbubvat
"}
