"aa" = (/turf/open/space,/area/space)
"ab" = (/turf/closed/wall/shuttle,/area/shuttle/escape)
"ac" = (/obj/structure/grille,/obj/structure/window/shuttle,/turf/open/floor/plasteel/shuttle/white,/area/shuttle/escape)
"ad" = (/obj/structure/bed,/turf/open/floor/plasteel/shuttle/red,/area/shuttle/escape)
"ae" = (/turf/open/floor/plasteel/shuttle/red,/area/shuttle/escape)
"af" = (/turf/open/floor/plasteel/shuttle/white,/area/shuttle/escape)
"ag" = (/obj/structure/bed,/turf/open/floor/plasteel/shuttle/white,/area/shuttle/escape)
"ah" = (/obj/machinery/door/airlock/glass_security{name = "Emergency Shuttle Brig"; req_access_txt = "2"},/turf/open/floor/plasteel/shuttle/red,/area/shuttle/escape)
"ai" = (/obj/machinery/door/airlock/glass_medical{id_tag = null; name = "Escape Shuttle Infirmary"; req_access_txt = "5"},/turf/open/floor/plasteel/shuttle/white,/area/shuttle/escape)
"aj" = (/obj/structure/chair,/turf/open/floor/plasteel/shuttle/red,/area/shuttle/escape)
"ak" = (/obj/machinery/light{icon_state = "tube1"; dir = 4},/turf/open/floor/plasteel/shuttle/red,/area/shuttle/escape)
"al" = (/obj/machinery/light{icon_state = "tube1"; dir = 8},/turf/open/floor/plasteel/shuttle/white,/area/shuttle/escape)
"am" = (/obj/machinery/sleeper,/turf/open/floor/plasteel/shuttle/white,/area/shuttle/escape)
"an" = (/obj/structure/closet/secure_closet/medical2,/turf/open/floor/plasteel/shuttle/white,/area/shuttle/escape)
"ao" = (/obj/structure/table,/obj/item/weapon/surgical_drapes,/obj/item/weapon/circular_saw,/turf/open/floor/plasteel/shuttle/white,/area/shuttle/escape)
"ap" = (/obj/machinery/door/airlock/shuttle,/turf/open/floor/plasteel/shuttle/red,/area/shuttle/escape)
"aq" = (/obj/structure/table/optable,/turf/open/floor/plasteel/shuttle/white,/area/shuttle/escape)
"ar" = (/obj/structure/chair{dir = 1},/turf/open/floor/plasteel/shuttle/red,/area/shuttle/escape)
"as" = (/obj/structure/chair{dir = 1},/obj/item/device/radio/intercom{freerange = 0; frequency = 1459; name = "Station Intercom (General)"; pixel_x = 0; pixel_y = -30},/turf/open/floor/plasteel/shuttle/red,/area/shuttle/escape)
"at" = (/obj/machinery/computer/security,/turf/open/floor/plasteel/shuttle/red,/area/shuttle/escape)
"au" = (/obj/machinery/computer/crew,/turf/open/floor/plasteel/shuttle/white,/area/shuttle/escape)
"av" = (/obj/item/device/radio/intercom{freerange = 0; frequency = 1459; name = "Station Intercom (General)"; pixel_x = 0; pixel_y = -30},/turf/open/floor/plasteel/shuttle/white,/area/shuttle/escape)
"aw" = (/obj/structure/table,/obj/item/weapon/hemostat,/obj/item/weapon/retractor,/obj/item/weapon/scalpel,/turf/open/floor/plasteel/shuttle/white,/area/shuttle/escape)
"ax" = (/obj/structure/bed/roller,/turf/open/floor/plasteel/shuttle,/area/shuttle/escape)
"ay" = (/turf/open/floor/plasteel/shuttle,/area/shuttle/escape)
"az" = (/obj/structure/chair{dir = 1},/turf/open/floor/plasteel/shuttle,/area/shuttle/escape)
"aA" = (/obj/structure/closet,/turf/open/floor/plasteel/shuttle,/area/shuttle/escape)
"aB" = (/obj/structure/table,/obj/item/weapon/storage/firstaid/fire,/obj/item/weapon/storage/firstaid/regular,/turf/open/floor/plasteel/shuttle,/area/shuttle/escape)
"aC" = (/obj/structure/chair{dir = 8},/turf/open/floor/plasteel/shuttle,/area/shuttle/escape)
"aD" = (/obj/structure/chair{dir = 4},/turf/open/floor/plasteel/shuttle,/area/shuttle/escape)
"aE" = (/obj/structure/table,/obj/item/weapon/crowbar,/obj/item/weapon/extinguisher,/obj/machinery/recharger,/turf/open/floor/plasteel/shuttle,/area/shuttle/escape)
"aF" = (/obj/machinery/door/airlock/shuttle,/obj/docking_port/mobile/emergency{dheight = 0; dir = 4; dwidth = 10; height = 13; name = "Asteroid emergency shuttle"; timid = 1; width = 28},/turf/open/floor/plasteel/shuttle/white,/area/shuttle/escape)
"aG" = (/obj/machinery/door/airlock/shuttle,/turf/open/floor/plasteel/shuttle/white,/area/shuttle/escape)
"aH" = (/obj/machinery/light{icon_state = "tube1"; dir = 4},/turf/open/floor/plasteel/shuttle,/area/shuttle/escape)
"aI" = (/obj/structure/chair{dir = 4},/obj/machinery/light{icon_state = "tube1"; dir = 8},/turf/open/floor/plasteel/shuttle,/area/shuttle/escape)
"aJ" = (/obj/structure/chair{dir = 8},/obj/structure/extinguisher_cabinet{pixel_x = 30},/turf/open/floor/plasteel/shuttle,/area/shuttle/escape)
"aK" = (/obj/structure/chair{dir = 8},/obj/item/device/radio/intercom{freerange = 0; frequency = 1459; name = "Station Intercom (General)"; pixel_x = 29},/turf/open/floor/plasteel/shuttle,/area/shuttle/escape)
"aL" = (/obj/structure/table,/obj/item/weapon/crowbar,/obj/item/weapon/extinguisher,/turf/open/floor/plasteel/shuttle,/area/shuttle/escape)
"aM" = (/obj/structure/chair,/turf/open/floor/plasteel/shuttle,/area/shuttle/escape)
"aN" = (/obj/structure/closet/emcloset,/turf/open/floor/plasteel/shuttle,/area/shuttle/escape)
"aO" = (/obj/structure/extinguisher_cabinet{pixel_x = -30},/turf/open/floor/plasteel/shuttle/white,/area/shuttle/escape)
"aP" = (/obj/machinery/door/airlock/glass_mining{name = "Emergency Shuttle Storage"},/turf/open/floor/plasteel/shuttle/yellow,/area/shuttle/escape)
"aQ" = (/obj/machinery/door/airlock/glass_command{name = "Emergency Shuttle Cockpit"; req_access_txt = "19"},/turf/open/floor/plasteel/shuttle,/area/shuttle/escape)
"aR" = (/obj/machinery/door/airlock{name = "Emergency Shuttle Restroom"},/turf/open/floor/plasteel/shuttle/white,/area/shuttle/escape)
"aS" = (/obj/machinery/recharge_station,/turf/open/floor/plasteel/shuttle/yellow,/area/shuttle/escape)
"aT" = (/turf/open/floor/plasteel/shuttle/yellow,/area/shuttle/escape)
"aU" = (/obj/item/device/radio/intercom{freerange = 0; frequency = 1459; name = "Station Intercom (General)"; pixel_x = -30},/turf/open/floor/plasteel/shuttle,/area/shuttle/escape)
"aV" = (/obj/structure/extinguisher_cabinet{pixel_x = 30},/turf/open/floor/plasteel/shuttle,/area/shuttle/escape)
"aW" = (/obj/machinery/disposal/bin/toilet{dir = 8},/turf/open/floor/plasteel/shuttle/white,/area/shuttle/escape)
"aX" = (/obj/machinery/door/airlock/shuttle,/turf/open/floor/plasteel/shuttle/yellow,/area/shuttle/escape)
"aY" = (/obj/structure/chair/office/light{dir = 4; name = "Head of Security"},/turf/open/floor/plasteel/shuttle,/area/shuttle/escape)
"aZ" = (/obj/structure/table,/obj/item/weapon/pen,/obj/item/weapon/folder/blue,/obj/machinery/recharger,/turf/open/floor/plasteel/shuttle,/area/shuttle/escape)
"ba" = (/obj/structure/chair/office/light{dir = 8; name = "Chief Medical Officer"},/turf/open/floor/plasteel/shuttle,/area/shuttle/escape)
"bb" = (/obj/structure/ore_box,/turf/open/floor/plasteel/shuttle/yellow,/area/shuttle/escape)
"bc" = (/obj/machinery/light{icon_state = "tube1"; dir = 4},/turf/open/floor/plasteel/shuttle/yellow,/area/shuttle/escape)
"bd" = (/obj/structure/chair/office/light{dir = 4; name = "Captain"},/obj/machinery/light{icon_state = "tube1"; dir = 8},/turf/open/floor/plasteel/shuttle,/area/shuttle/escape)
"be" = (/obj/machinery/computer/shuttle,/turf/open/floor/plasteel/shuttle,/area/shuttle/escape)
"bf" = (/obj/structure/chair/office/light{dir = 8; name = "Head of Personnel"},/obj/machinery/light{icon_state = "tube1"; dir = 4},/turf/open/floor/plasteel/shuttle,/area/shuttle/escape)
"bg" = (/obj/machinery/suit_storage_unit,/turf/open/floor/plasteel/shuttle/yellow,/area/shuttle/escape)
"bh" = (/obj/structure/chair/office/light{dir = 4; name = "Chief Engineer"},/turf/open/floor/plasteel/shuttle,/area/shuttle/escape)
"bi" = (/obj/structure/table,/obj/item/weapon/paper_bin,/turf/open/floor/plasteel/shuttle,/area/shuttle/escape)
"bj" = (/obj/structure/chair/office/light{dir = 8; name = "Research Director"},/turf/open/floor/plasteel/shuttle,/area/shuttle/escape)
"bk" = (/obj/structure/sink{dir = 4; icon_state = "sink"; pixel_x = 11; pixel_y = 0},/obj/structure/mirror{pixel_x = 30},/turf/open/floor/plasteel/shuttle/white,/area/shuttle/escape)
"bl" = (/obj/structure/shuttle/engine/heater,/turf/open/floor/plating/airless,/area/shuttle/escape)
"bm" = (/obj/structure/shuttle/engine/propulsion,/turf/open/floor/plating/airless,/area/shuttle/escape)
"bn" = (/obj/machinery/computer/station_alert,/turf/open/floor/plasteel/shuttle,/area/shuttle/escape)
"bo" = (/obj/machinery/computer/communications,/turf/open/floor/plasteel/shuttle,/area/shuttle/escape)

(1,1,1) = {"
aaaaaaababacabacababaaaaaa
aaaaababadaeacafagababaaaa
ababababacahabaiacabababab
abajajajaeakabalafamanaoab
apaeaeaeaeaeacafafafafaqac
abarasaraeatabauafafavawab
abababacahacabacaiacababab
aaababaxafafafafafaxababaa
aaaaabayafazazazafaAabaaaa
abacabaBafaCacaDafaEabaaaa
aFafaGafafaCacaDafaHabaaaa
abacabaIafaCacaDafaJabaaaa
aaaaacaDafaCacaDafaCacaaaa
aaaaacaDafafafafafaCacaaaa
aaaaacaDafaCacaDafaCacaaaa
abacabaIafaCacaDafaKabaaaa
aGafaGafafaCacaDafaHabaaaa
abacabaLafaCacaDafaBabaaaa
aaaaabayafaMaMaMafaNabaaaa
aaababaOafafafafafafababaa
abababaPababaQababaRababab
acaSaTaTabaUayaVabafaRaWac
aXaTaTaTabaYaZbaabafababab
acbbaTbcabbdbebfabalaRaWac
abababbgabbhbibjabbkababab
abblabababayayayabababblab
abbmabblabbnayboabblabbmab
aaaaabbmabacacacabbmabaaaa
"}
