//MAP CONVERTED BY dmm2tgm.py THIS HEADER COMMENT PREVENTS RECONVERSION, DO NOT REMOVE 
"aa" = (
/turf/open/space,
/area/space)
"ab" = (
/turf/closed/wall/shuttle/smooth,
/area/shuttle/escape)
"ac" = (
/obj/structure/grille,
/obj/structure/window/shuttle/tinted,
/turf/open/floor/plating,
/area/shuttle/escape)
"ad" = (
/obj/structure/table,
/obj/item/weapon/storage/firstaid,
/turf/open/floor/plasteel/shuttle/white,
/area/shuttle/escape)
"ae" = (
/obj/machinery/computer/emergency_shuttle,
/turf/open/floor/plasteel/shuttle/white,
/area/shuttle/escape)
"af" = (
/obj/structure/table,
/obj/machinery/recharger,
/obj/structure/extinguisher_cabinet{
	pixel_x = 30
	},
/turf/open/floor/plasteel/shuttle/white,
/area/shuttle/escape)
"ag" = (
/turf/closed/wall/shuttle/smooth/nodiagonal,
/area/shuttle/escape)
"ah" = (
/obj/machinery/light{
	icon_state = "tube1";
	dir = 8
	},
/turf/open/floor/plasteel/shuttle,
/area/shuttle/escape)
"ai" = (
/obj/structure/chair/comfy{
	tag = "icon-comfychair (NORTH)";
	icon_state = "comfychair";
	dir = 1
	},
/turf/open/floor/plasteel/shuttle,
/area/shuttle/escape)
"aj" = (
/turf/open/floor/plasteel/shuttle,
/area/shuttle/escape)
"ak" = (
/obj/structure/closet,
/turf/open/floor/plasteel/shuttle/yellow,
/area/shuttle/escape)
"al" = (
/obj/machinery/recharge_station,
/turf/open/floor/plasteel/shuttle/yellow,
/area/shuttle/escape)
"am" = (
/obj/machinery/vending/cola,
/turf/open/floor/plasteel/shuttle/yellow,
/area/shuttle/escape)
"an" = (
/obj/machinery/computer/atmos_alert,
/turf/open/floor/plasteel/shuttle/white,
/area/shuttle/escape)
"ao" = (
/obj/structure/chair{
	dir = 8
	},
/turf/open/floor/plasteel/shuttle,
/area/shuttle/escape)
"ap" = (
/obj/structure/chair{
	dir = 4
	},
/turf/open/floor/plasteel/shuttle,
/area/shuttle/escape)
"aq" = (
/obj/machinery/computer/security,
/turf/open/floor/plasteel/shuttle/white,
/area/shuttle/escape)
"ar" = (
/obj/structure/chair,
/turf/open/floor/plasteel/shuttle/red,
/area/shuttle/escape)
"as" = (
/turf/open/floor/plasteel/shuttle/yellow,
/area/shuttle/escape)
"at" = (
/obj/structure/extinguisher_cabinet{
	pixel_x = 30
	},
/obj/machinery/light/small{
	dir = 4
	},
/turf/open/floor/plasteel/shuttle/yellow,
/area/shuttle/escape)
"au" = (
/obj/machinery/computer/crew,
/turf/open/floor/plasteel/shuttle/white,
/area/shuttle/escape)
"av" = (
/obj/machinery/computer/communications,
/turf/open/floor/plasteel/shuttle/white,
/area/shuttle/escape)
"aw" = (
/obj/machinery/flasher{
	id = "shuttleflash";
	pixel_x = -25;
	pixel_y = 7
	},
/obj/machinery/button/flasher{
	id = "shuttleflash";
	pixel_x = -25;
	pixel_y = -7
	},
/obj/machinery/light/small{
	dir = 8
	},
/turf/open/floor/plasteel/shuttle/red,
/area/shuttle/escape)
"ax" = (
/turf/open/floor/plasteel/shuttle/red,
/area/shuttle/escape)
"ay" = (
/obj/machinery/door/airlock/shuttle,
/obj/docking_port/mobile/emergency{
	dwidth = 5;
	height = 15;
	timid = 1;
	width = 18
	},
/turf/open/floor/plasteel/shuttle/yellow,
/area/shuttle/escape)
"az" = (
/obj/structure/reagent_dispensers/fueltank,
/turf/open/floor/plasteel/shuttle/yellow,
/area/shuttle/escape)
"aA" = (
/obj/machinery/door/airlock/glass{
	name = "Emergency Shuttle Cockpit";
	req_access_txt = "19"
	},
/turf/open/floor/plasteel/shuttle,
/area/shuttle/escape)
"aB" = (
/obj/structure/chair{
	dir = 1
	},
/turf/open/floor/plasteel/shuttle/red,
/area/shuttle/escape)
"aC" = (
/obj/machinery/door/airlock/shuttle,
/turf/open/floor/plasteel/shuttle/red,
/area/shuttle/escape)
"aD" = (
/obj/machinery/door/airlock/glass{
	name = "Emergency Shuttle Cargo Hold"
	},
/turf/open/floor/plasteel/shuttle,
/area/shuttle/escape)
"aE" = (
/obj/structure/flora/kirbyplants,
/turf/open/floor/plasteel/shuttle,
/area/shuttle/escape)
"aF" = (
/obj/machinery/door/airlock/glass{
	name = "Emergency Shuttle Brig";
	req_access_txt = "2"
	},
/turf/open/floor/plasteel/shuttle,
/area/shuttle/escape)
"aG" = (
/turf/open/floor/plasteel/shuttle/white,
/area/shuttle/escape)
"aH" = (
/obj/machinery/light{
	dir = 1
	},
/turf/open/floor/plasteel/shuttle,
/area/shuttle/escape)
"aI" = (
/obj/structure/chair{
	dir = 4
	},
/turf/open/floor/plasteel/shuttle/white,
/area/shuttle/escape)
"aJ" = (
/obj/structure/chair{
	dir = 8
	},
/obj/structure/window{
	icon_state = "rwindow";
	dir = 4
	},
/turf/open/floor/plasteel/shuttle/white,
/area/shuttle/escape)
"aK" = (
/obj/structure/chair{
	dir = 4
	},
/obj/structure/window{
	icon_state = "rwindow";
	dir = 8
	},
/turf/open/floor/plasteel/shuttle/white,
/area/shuttle/escape)
"aL" = (
/turf/open/floor/carpet,
/area/shuttle/escape)
"aM" = (
/obj/structure/chair/comfy,
/turf/open/floor/carpet,
/area/shuttle/escape)
"aN" = (
/obj/structure/chair{
	dir = 8
	},
/turf/open/floor/plasteel/shuttle/white,
/area/shuttle/escape)
"aO" = (
/obj/structure/chair/comfy{
	tag = "icon-comfychair (EAST)";
	icon_state = "comfychair";
	dir = 4
	},
/turf/open/floor/carpet,
/area/shuttle/escape)
"aP" = (
/obj/structure/table/wood/poker,
/obj/item/toy/cards/deck,
/turf/open/floor/carpet,
/area/shuttle/escape)
"aQ" = (
/obj/structure/chair/comfy{
	tag = "icon-comfychair (WEST)";
	icon_state = "comfychair";
	dir = 8
	},
/turf/open/floor/carpet,
/area/shuttle/escape)
"aR" = (
/obj/structure/chair/comfy{
	tag = "icon-comfychair (NORTH)";
	icon_state = "comfychair";
	dir = 1
	},
/turf/open/floor/carpet,
/area/shuttle/escape)
"aS" = (
/obj/machinery/door/airlock/shuttle,
/turf/open/floor/plasteel/shuttle/white,
/area/shuttle/escape)
"aT" = (
/obj/machinery/light,
/turf/open/floor/plasteel/shuttle,
/area/shuttle/escape)
"aU" = (
/obj/machinery/door/airlock/glass{
	name = "Emergency Shuttle Infirmary"
	},
/turf/open/floor/plasteel/shuttle,
/area/shuttle/escape)
"aV" = (
/obj/machinery/sleeper{
	icon_state = "sleeper-open";
	dir = 4
	},
/turf/open/floor/plasteel/shuttle/white,
/area/shuttle/escape)
"aW" = (
/obj/machinery/vending/medical,
/turf/open/floor/plasteel/shuttle/white,
/area/shuttle/escape)
"aX" = (
/obj/machinery/light{
	icon_state = "tube1";
	dir = 8
	},
/turf/open/floor/plasteel/shuttle/white,
/area/shuttle/escape)
"aY" = (
/obj/structure/table,
/obj/item/weapon/storage/firstaid,
/obj/item/weapon/storage/firstaid/fire,
/obj/item/weapon/crowbar,
/obj/structure/sign/nosmoking_2{
	pixel_x = 30
	},
/obj/machinery/light{
	icon_state = "tube1";
	dir = 4
	},
/turf/open/floor/plasteel/shuttle/white,
/area/shuttle/escape)
"aZ" = (
/obj/structure/shuttle/engine/heater,
/obj/structure/window/shuttle/tinted,
/turf/open/floor/plating,
/area/shuttle/escape)
"ba" = (
/obj/structure/table,
/obj/item/weapon/defibrillator/loaded,
/turf/open/floor/plasteel/shuttle/white,
/area/shuttle/escape)
"bb" = (
/obj/structure/shuttle/engine/propulsion,
/turf/open/floor/plating,
/area/shuttle/escape)

(1,1,1) = {"
aa
aa
ab
ac
ac
ay
ag
ab
ac
ac
ab
aS
ab
aS
ab
ab
ab
aa
"}
(2,1,1) = {"
aa
aa
ab
ak
as
as
ac
aG
aI
aI
aI
aG
aI
aG
aI
aZ
bb
aa
"}
(3,1,1) = {"
aa
aa
ab
al
as
as
aD
aj
aj
aj
aj
aj
aj
aj
aj
aZ
bb
aa
"}
(4,1,1) = {"
aa
aa
ab
am
at
az
ac
aj
aJ
aJ
aJ
aj
aj
aN
aN
aZ
bb
aa
"}
(5,1,1) = {"
aa
aa
ab
ab
ab
ab
ag
aH
aK
aK
aK
aT
ag
ab
ab
ab
ab
ab
"}
(6,1,1) = {"
ab
ab
ag
an
au
ab
aE
aj
aj
aj
aj
aj
ab
aV
aX
aV
aZ
bb
"}
(7,1,1) = {"
ac
ad
ah
ao
ao
ac
aj
aj
aL
aO
aL
aj
ac
aG
aG
aG
aZ
bb
"}
(8,1,1) = {"
ac
ae
ai
aj
aj
aA
aj
aj
aM
aP
aR
aj
aU
aG
aG
aG
aZ
bb
"}
(9,1,1) = {"
ac
af
aj
ap
ap
ac
aj
aj
aL
aQ
aL
aj
ac
aG
aI
aI
aZ
bb
"}
(10,1,1) = {"
ab
ab
ag
aq
av
ab
aE
aj
aj
aj
aj
aj
ab
aW
aY
ba
aZ
bb
"}
(11,1,1) = {"
aa
aa
ab
ab
ab
ab
ag
aH
aJ
aJ
aJ
aT
ag
ab
ab
ab
ab
ab
"}
(12,1,1) = {"
aa
aa
ab
ar
aw
aB
ac
aj
aK
aK
aK
aj
aj
aI
aI
aZ
bb
aa
"}
(13,1,1) = {"
aa
aa
ab
ar
ax
ax
aF
aj
aj
aj
aj
aj
aj
aj
aj
aZ
bb
aa
"}
(14,1,1) = {"
aa
aa
ab
ar
ax
ax
ac
aG
aN
aN
aN
aG
aN
aG
aN
aZ
bb
aa
"}
(15,1,1) = {"
aa
aa
ab
ac
ac
aC
ag
ab
ac
ac
ab
aS
ab
aS
ab
ab
ab
aa
"}
