"a" = (/turf/template_noop,/area/template_noop)
"b" = (/obj/structure/table/wood,/obj/item/toy/figure/wizard{pixel_x = -6; pixel_y = 4},/obj/item/weapon/paper/rpg{pixel_x = 8},/obj/effect/decal/cleanable/cobweb,/turf/open/floor/wood,/area/template_noop)
"c" = (/obj/structure/table/wood,/obj/item/weapon/storage/pill_bottle/dice,/obj/machinery/light/small{dir = 1},/turf/open/floor/wood,/area/template_noop)
"d" = (/obj/item/weapon/book/manual/dwarf,/turf/open/floor/wood,/area/template_noop)
"e" = (/obj/structure/closet/crate/freezer,/obj/item/weapon/reagent_containers/food/drinks/drinkingglass{desc = "A manly concoction made from Ale and Beer. Intended for true men only."; icon_state = "manlydorfglass"; list_reagents = list("manlydorf" = 30); name = "Manly Dorf"},/obj/item/weapon/reagent_containers/food/drinks/drinkingglass{desc = "A manly concoction made from Ale and Beer. Intended for true men only."; icon_state = "manlydorfglass"; list_reagents = list("manlydorf" = 30); name = "Manly Dorf"},/obj/item/weapon/reagent_containers/food/drinks/drinkingglass{desc = "A manly concoction made from Ale and Beer. Intended for true men only."; icon_state = "manlydorfglass"; list_reagents = list("manlydorf" = 30); name = "Manly Dorf"},/obj/item/weapon/reagent_containers/food/drinks/drinkingglass{desc = "A manly concoction made from Ale and Beer. Intended for true men only."; icon_state = "manlydorfglass"; list_reagents = list("manlydorf" = 30); name = "Manly Dorf"},/obj/item/weapon/reagent_containers/food/drinks/ale,/obj/effect/decal/cleanable/cobweb2,/turf/open/floor/wood,/area/template_noop)
"f" = (/obj/structure/chair/wood{dir = 1},/turf/open/floor/wood,/area/template_noop)
"g" = (/turf/open/floor/wood{tag = "icon-wood-broken6"; icon_state = "wood-broken6"},/area/template_noop)
"h" = (/turf/open/floor/wood,/area/template_noop)
"i" = (/obj/machinery/door/airlock/maintenance{req_access_txt = "12"},/turf/open/floor/wood{tag = "icon-wood-broken4"; icon_state = "wood-broken4"},/area/template_noop)
"j" = (/obj/structure/bookcase/manuals/rpg/dwarf,/obj/item/weapon/book/manual/rpg,/obj/item/weapon/book/manual/rpg/equipment,/obj/item/weapon/book/manual/rpg/guide,/obj/item/weapon/book/manual/rpg/packs,/obj/item/weapon/book/manual/rpg/spells,/turf/open/floor/wood,/area/template_noop)
"k" = (/obj/item/weapon/ore/iron{pixel_x = 3; pixel_y = -3},/obj/item/weapon/ore/iron,/obj/item/weapon/pickaxe,/turf/open/floor/wood,/area/template_noop)
"l" = (/turf/open/floor/wood{tag = "icon-wood-broken4"; icon_state = "wood-broken4"},/area/template_noop)
"m" = (/obj/structure/closet/crate/necropolis,/obj/item/weapon/shield/riot/buckler,/obj/item/clothing/under/gladiator,/obj/item/clothing/head/helmet/gladiator,/obj/item/clothing/shoes/sandal,/turf/open/floor/wood,/area/template_noop)

(1,1,1) = {"
aaaaaa
abcdea
afghhi
ajklma
aaaaaa
"}
