"aa" = (/turf/open/space,/area/space)
"ab" = (/obj/structure/grille,/obj/structure/window/reinforced/fulltile,/turf/open/floor/plating,/area/quartermaster/miningdock)
"ac" = (/obj/machinery/computer/crew,/turf/open/floor/plasteel/whiteblue/side{tag = "icon-whiteblue (NORTHWEST)"; icon_state = "whiteblue"; dir = 9},/area/quartermaster/miningdock)
"ad" = (/turf/open/floor/plasteel/whiteblue/side{baseturf = /turf/open/floor/plating/lava/smooth/lava_land_surface; dir = 1; icon_state = "whiteblue"; tag = "icon-whiteblue (NORTH)"},/area/quartermaster/miningdock)
"ae" = (/obj/machinery/jauntbeacon/mother,/obj/machinery/atmospherics/components/unary/vent_scrubber{dir = 4; on = 1; scrub_N2O = 0; scrub_Toxins = 0},/turf/open/floor/plasteel/whiteblue/side{baseturf = /turf/open/floor/plating/lava/smooth/lava_land_surface; dir = 1; icon_state = "whiteblue"; tag = "icon-whiteblue (NORTH)"},/area/quartermaster/miningdock)
"af" = (/obj/machinery/atmospherics/pipe/simple/scrubbers/hidden{dir = 4},/turf/closed/wall,/area/quartermaster/miningdock)
"ag" = (/obj/structure/table,/obj/item/weapon/folder/yellow,/obj/item/weapon/pen,/obj/machinery/requests_console{department = "Mining"; departmentType = 0; pixel_x = -30; pixel_y = 0},/obj/machinery/light{dir = 8},/obj/machinery/atmospherics/pipe/simple/scrubbers/hidden{dir = 4},/turf/open/floor/plasteel,/area/quartermaster/miningdock)
"ah" = (/obj/structure/chair/office/dark{dir = 8},/obj/machinery/atmospherics/pipe/simple/scrubbers/hidden{dir = 4},/turf/open/floor/plasteel,/area/quartermaster/miningdock)
"ai" = (/obj/structure/disposalpipe/segment{dir = 1; icon_state = "pipe-c"},/obj/structure/cable/yellow{d1 = 1; d2 = 4; icon_state = "1-4"},/obj/machinery/atmospherics/pipe/simple/supply/hidden,/obj/machinery/atmospherics/pipe/simple/scrubbers/hidden{dir = 4},/turf/open/floor/plasteel,/area/quartermaster/miningdock)
"aj" = (/obj/structure/cable/yellow{d1 = 4; d2 = 8; icon_state = "4-8"; pixel_x = 0},/obj/structure/disposalpipe/segment{dir = 4},/obj/machinery/atmospherics/pipe/manifold4w/scrubbers/hidden,/turf/open/floor/plasteel,/area/quartermaster/miningdock)
"ak" = (/obj/structure/cable/yellow{d1 = 4; d2 = 8; icon_state = "4-8"; pixel_x = 0},/obj/structure/disposalpipe/segment{dir = 4},/obj/machinery/atmospherics/pipe/simple/scrubbers/hidden{dir = 4},/turf/open/floor/plasteel,/area/quartermaster/miningdock)
"al" = (/obj/machinery/door/airlock/maintenance{name = "Mining Maintenance"; req_access_txt = "48"},/obj/structure/disposalpipe/segment{dir = 4},/obj/structure/cable/yellow{d1 = 4; d2 = 8; icon_state = "4-8"; pixel_x = 0},/obj/machinery/atmospherics/pipe/simple/scrubbers/hidden{dir = 4},/turf/open/floor/plating,/area/quartermaster/miningdock)
"am" = (/turf/open/space,/turf/closed/indestructible/opshuttle{tag = "icon-wall3 (NORTHWEST)"; icon_state = "wall3"; dir = 9},/area/shuttle/miningbus)
"an" = (/obj/machinery/computer/shuttle/miningbus,/turf/open/floor/plating/airless,/area/shuttle/miningbus)
"ao" = (/turf/open/space,/turf/closed/indestructible/opshuttle{tag = "icon-wall3 (NORTHEAST)"; icon_state = "wall3"; dir = 5},/area/shuttle/miningbus)
"ap" = (/obj/machinery/computer/security/mining/medic,/turf/open/floor/plasteel{dir = 8; icon_state = "whiteblue"},/area/quartermaster/miningdock)
"aq" = (/obj/effect/landmark/start{name = "Mining Medic"},/turf/open/floor/plasteel/white{baseturf = /turf/open/floor/plating/lava/smooth/lava_land_surface},/area/quartermaster/miningdock)
"ar" = (/obj/machinery/atmospherics/components/unary/vent_pump{dir = 4; on = 1},/turf/open/floor/plasteel/white{baseturf = /turf/open/floor/plating/lava/smooth/lava_land_surface},/area/quartermaster/miningdock)
"as" = (/obj/machinery/door/airlock/glass_medical{id_tag = "MiningMedic"; name = "Mining Medic"; req_access_txt = "5"},/obj/machinery/atmospherics/pipe/simple/supply/hidden{dir = 4},/turf/open/floor/plasteel/white{baseturf = /turf/open/floor/plating/lava/smooth/lava_land_surface},/area/quartermaster/miningdock)
"at" = (/obj/machinery/atmospherics/pipe/simple/supply/hidden{dir = 4},/turf/open/floor/plasteel,/area/quartermaster/miningdock)
"au" = (/obj/machinery/atmospherics/pipe/manifold/supply/hidden,/turf/open/floor/plasteel,/area/quartermaster/miningdock)
"av" = (/obj/machinery/atmospherics/pipe/simple/supply/hidden{dir = 4},/obj/machinery/atmospherics/pipe/simple/scrubbers/hidden,/turf/open/floor/plasteel,/area/quartermaster/miningdock)
"aw" = (/obj/machinery/airalarm{dir = 8; icon_state = "alarm0"; pixel_x = 24},/obj/machinery/atmospherics/pipe/simple/supply/hidden{dir = 4},/turf/open/floor/plasteel,/area/quartermaster/miningdock)
"ax" = (/obj/machinery/atmospherics/pipe/manifold/supply/hidden{dir = 1},/turf/closed/wall,/area/quartermaster/miningdock)
"ay" = (/turf/open/floor/plating,/area/shuttle/miningbus)
"az" = (/obj/structure/chair{dir = 1},/obj/machinery/light,/turf/open/floor/plating,/area/shuttle/miningbus)
"aA" = (/turf/closed/wall,/area/quartermaster/miningdock)
"aB" = (/obj/machinery/suit_storage_unit/mmedic,/turf/open/floor/plasteel{dir = 10; icon_state = "whiteblue"},/area/quartermaster/miningdock)
"aC" = (/obj/machinery/light,/turf/open/floor/plasteel/whiteblue/side,/area/quartermaster/miningdock)
"aD" = (/obj/structure/closet/secure_closet/mmedical,/obj/item/device/radio/intercom{dir = 4; name = "Station Intercom (General)"; pixel_x = 27},/turf/open/floor/plasteel/whiteblue/side,/area/quartermaster/miningdock)
"aE" = (/obj/structure/ore_box,/turf/open/floor/plasteel,/area/quartermaster/miningdock)
"aF" = (/obj/machinery/atmospherics/components/unary/vent_scrubber{dir = 4; on = 1; scrub_N2O = 0; scrub_Toxins = 0},/turf/open/floor/plasteel,/area/quartermaster/miningdock)
"aG" = (/obj/machinery/atmospherics/pipe/simple/scrubbers/hidden{dir = 4},/obj/structure/closet/crate,/obj/machinery/light,/turf/open/floor/plasteel,/area/quartermaster/miningdock)
"aH" = (/obj/machinery/atmospherics/pipe/manifold/scrubbers/hidden,/turf/open/floor/plasteel,/area/quartermaster/miningdock)
"aI" = (/obj/machinery/atmospherics/pipe/simple/scrubbers/hidden{dir = 10},/turf/open/floor/plasteel,/area/quartermaster/miningdock)
"aJ" = (/obj/machinery/atmospherics/pipe/simple/supply/hidden{req_access_txt = 1},/turf/closed/wall,/area/quartermaster/miningdock)
"aK" = (/obj/structure/chair{dir = 8},/turf/open/floor/plating,/area/shuttle/miningbus)
"aL" = (/turf/closed/indestructible/opshuttle{tag = "icon-wall3 (WEST)"; icon_state = "wall3"; dir = 8},/area/shuttle/miningbus)
"aM" = (/obj/structure/chair{dir = 4},/turf/open/floor/plating,/area/shuttle/miningbus)
"aN" = (/obj/machinery/door/airlock/glass_mining{name = "Mining EVA"; req_access_txt = "48"},/turf/open/floor/plasteel,/area/quartermaster/miningdock)
"aO" = (/obj/structure/grille,/obj/structure/window/reinforced/fulltile,/obj/structure/sign/securearea{desc = "A warning sign which reads 'EXTERNAL AIRLOCK'"; icon_state = "space"; layer = 4; name = "EXTERNAL AIRLOCK"; pixel_x = 0},/turf/open/floor/plating,/area/quartermaster/miningdock)
"aP" = (/obj/item/weapon/ore/iron,/obj/item/weapon/ore/silver,/obj/item/weapon/ore/silver,/turf/open/floor/plasteel{dir = 9; icon_state = "warning"},/area/quartermaster/miningdock)
"aQ" = (/obj/structure/closet/crate,/turf/open/floor/plasteel{dir = 1; icon_state = "warning"},/area/quartermaster/miningdock)
"aR" = (/obj/machinery/camera{c_tag = "Mining Dock External"; dir = 8},/obj/structure/reagent_dispensers/fueltank,/obj/machinery/light/small{dir = 4},/obj/item/device/radio/intercom{dir = 4; name = "Station Intercom (General)"; pixel_x = 27},/turf/open/floor/plasteel{dir = 1; icon_state = "warning"},/area/quartermaster/miningdock)
"aS" = (/obj/structure/ore_box,/obj/machinery/light{dir = 1},/turf/open/floor/plasteel{dir = 9; icon_state = "brown"},/area/quartermaster/miningdock)
"aT" = (/obj/structure/ore_box,/turf/open/floor/plasteel{dir = 1; icon_state = "brown"},/area/quartermaster/miningdock)
"aU" = (/obj/item/organ/heart/demon,/obj/machinery/suit_storage_unit/mining/void,/turf/open/floor/plasteel{dir = 1; icon_state = "brown"},/area/quartermaster/miningdock)
"aV" = (/obj/machinery/suit_storage_unit/mining/void,/turf/open/floor/plasteel{dir = 1; icon_state = "brown"},/area/quartermaster/miningdock)
"aW" = (/obj/machinery/suit_storage_unit/mining/void,/obj/machinery/light{dir = 1},/turf/open/floor/plasteel{dir = 1; icon_state = "brown"},/area/quartermaster/miningdock)
"aX" = (/obj/machinery/atmospherics/pipe/simple/scrubbers/hidden,/obj/item/device/radio/intercom{dir = 4; name = "Station Intercom (General)"; pixel_x = 27},/turf/open/floor/plasteel{dir = 5; icon_state = "brown"},/area/quartermaster/miningdock)
"aY" = (/obj/machinery/light{dir = 1},/turf/open/floor/plasteel/bot,/area/shuttle/miningbus)
"aZ" = (/obj/docking_port/mobile{dir = 8; dwidth = 3; height = 5; id = "miningbus"; name = "mining bus"; travelDir = 180; width = 8},/obj/docking_port/stationary{dir = 8; dwidth = 3; height = 5; id = "mining_home"; name = "Tinystation docking"; width = 8},/turf/open/floor/plating,/area/shuttle/miningbus)
"ba" = (/obj/machinery/door/airlock/external{name = "Mining Dock Airlock"; req_access = null; req_access_txt = "48"},/turf/open/floor/plasteel,/area/quartermaster/miningdock)
"bb" = (/turf/open/floor/plasteel,/area/quartermaster/miningdock)
"bc" = (/obj/machinery/door/airlock/glass_mining{name = "Mining Dock"; req_access_txt = "48"},/turf/open/floor/plasteel,/area/quartermaster/miningdock)
"bd" = (/turf/open/floor/plasteel{dir = 8; icon_state = "brown"},/area/quartermaster/miningdock)
"be" = (/obj/effect/landmark/event_spawn,/turf/open/floor/plasteel,/area/quartermaster/miningdock)
"bf" = (/obj/machinery/camera{c_tag = "Mining EVA Internal"; dir = 8},/obj/machinery/atmospherics/pipe/manifold/scrubbers/hidden{tag = "icon-manifold-r-f (EAST)"; dir = 4},/turf/open/floor/plasteel{dir = 4; icon_state = "brown"},/area/quartermaster/miningdock)
"bg" = (/turf/open/floor/plasteel/bot,/area/shuttle/miningbus)
"bh" = (/obj/machinery/door/airlock/glass_mining{name = "Mining Dock"; req_access_txt = "48"},/obj/machinery/atmospherics/pipe/simple/scrubbers/hidden{dir = 4},/turf/open/floor/plasteel,/area/quartermaster/miningdock)
"bi" = (/obj/machinery/atmospherics/pipe/simple/scrubbers/hidden{dir = 4},/turf/open/floor/plasteel{dir = 8; icon_state = "brown"},/area/quartermaster/miningdock)
"bj" = (/obj/machinery/atmospherics/pipe/simple/scrubbers/hidden{dir = 4},/turf/open/floor/plasteel,/area/quartermaster/miningdock)
"bk" = (/obj/machinery/atmospherics/pipe/simple/scrubbers/hidden{dir = 9},/obj/machinery/atmospherics/components/unary/vent_pump{dir = 4; on = 1},/turf/open/floor/plasteel{dir = 4; icon_state = "brown"},/area/quartermaster/miningdock)
"bl" = (/obj/machinery/atmospherics/pipe/manifold/supply/hidden{dir = 4},/turf/closed/wall,/area/quartermaster/miningdock)
"bm" = (/obj/structure/shuttle/engine/heater,/turf/closed/indestructible/opshuttle,/area/shuttle/miningbus)
"bn" = (/obj/machinery/mineral/equipment_vendor,/turf/open/floor/plasteel{dir = 10; icon_state = "warning"},/area/quartermaster/miningdock)
"bo" = (/obj/structure/closet/emcloset,/turf/open/floor/plasteel{icon_state = "warning"},/area/quartermaster/miningdock)
"bp" = (/obj/structure/closet/wardrobe/miner,/obj/machinery/atmospherics/components/unary/vent_pump{dir = 4; on = 1},/obj/machinery/light/small{dir = 4},/turf/open/floor/plasteel{icon_state = "warning"},/area/quartermaster/miningdock)
"bq" = (/obj/machinery/atmospherics/pipe/simple/supply/hidden{dir = 4},/turf/closed/wall,/area/quartermaster/miningdock)
"br" = (/obj/machinery/atmospherics/pipe/simple/supply/hidden{dir = 4},/obj/machinery/light,/obj/machinery/computer/shuttle/miningbus,/turf/open/floor/plasteel{dir = 10; icon_state = "brown"},/area/quartermaster/miningdock)
"bs" = (/obj/machinery/atmospherics/pipe/simple/supply/hidden{dir = 4},/obj/structure/tank_dispenser/oxygen,/turf/open/floor/plasteel{dir = 2; icon_state = "brown"},/area/quartermaster/miningdock)
"bt" = (/obj/effect/landmark/start{name = "Shaft Miner"},/obj/machinery/atmospherics/pipe/simple/supply/hidden{dir = 4},/turf/open/floor/plasteel{dir = 8; icon_state = "browncorner"},/area/quartermaster/miningdock)
"bu" = (/obj/effect/landmark/start{name = "Shaft Miner"},/obj/machinery/atmospherics/pipe/simple/supply/hidden{dir = 4},/turf/open/floor/plasteel,/area/quartermaster/miningdock)
"bv" = (/obj/effect/landmark/start{name = "Shaft Miner"},/obj/machinery/atmospherics/pipe/simple/supply/hidden{dir = 4},/turf/open/floor/plasteel{dir = 2; icon_state = "browncorner"},/area/quartermaster/miningdock)
"bw" = (/obj/machinery/atmospherics/pipe/simple/supply/hidden{dir = 4},/obj/structure/ore_box,/turf/open/floor/plasteel{dir = 6; icon_state = "brown"},/area/quartermaster/miningdock)
"bx" = (/obj/machinery/atmospherics/pipe/simple/supply/hidden{dir = 9},/turf/closed/wall,/area/quartermaster/miningdock)
"by" = (/obj/structure/shuttle/engine/propulsion{icon_state = "propulsion_l"},/turf/open/floor/plating,/area/shuttle/miningbus)
"bz" = (/obj/structure/shuttle/engine/propulsion,/turf/open/floor/plating,/area/shuttle/miningbus)
"bA" = (/obj/structure/shuttle/engine/propulsion{icon_state = "propulsion_r"},/turf/open/floor/plating,/area/shuttle/miningbus)
"bB" = (/obj/structure/closet/secure_closet/miner,/obj/item/clothing/shoes/magboots,/turf/open/floor/plasteel{dir = 10; icon_state = "brown"},/area/quartermaster/miningdock)
"bC" = (/obj/structure/closet/secure_closet/miner,/obj/item/clothing/shoes/magboots,/turf/open/floor/plasteel{dir = 2; icon_state = "brown"},/area/quartermaster/miningdock)
"bD" = (/obj/structure/closet/secure_closet/miner,/obj/machinery/light,/obj/item/clothing/shoes/magboots,/turf/open/floor/plasteel{dir = 2; icon_state = "brown"},/area/quartermaster/miningdock)
"bE" = (/obj/structure/closet/secure_closet/miner,/obj/item/clothing/shoes/magboots,/turf/open/floor/plasteel{dir = 6; icon_state = "brown"},/area/quartermaster/miningdock)

(1,1,1) = {"
aaaaaaaaaaaaabacadaeafagahaiajakal
amanaoaaaaaaabapaqarasatatauavawax
ayazayaaaaaaaAaBaCaDaAaEaFaGaHaIaJ
aKaLaMabababaAaAaAaAaAaAaAaAaAaNaJ
aKaLaMaOaPaQaRaAaSaTaUaVaWaVaVaXaJ
ayaYaZbabbbbbbbcbdbbbbbbbbbeaFbfaJ
bgbgbgbabbbbaFbhbibjbjbjbjbjbjbkbl
bmbmbmaObnbobpbqbrbsbtbubububvbwbx
bybzbAababababaAaAaAbBbCbDbCbEaAaA
"}
