"aa" = (/turf/open/floor/plating/airless,/area/space)
"ab" = (/turf/open/floor/plating/airless{dir = 2;icon_state = "warnplate"},/area/space)
"ac" = (/obj/structure/sign/securearea{desc = "A warning sign which reads 'KEEP CLEAR OF DOCKING AREA'.";name = "KEEP CLEAR: DOCKING AREA";pixel_y = 32},/turf/open/floor/plating/airless{dir = 2;icon_state = "warnplate"},/area/space)
"ad" = (/turf/open/space,/area/space)
"ae" = (/turf/closed/wall,/area/quartermaster/miningdock)
"af" = (/obj/structure/table,/obj/item/weapon/folder/yellow,/obj/item/weapon/pen,/obj/machinery/requests_console{department = "Mining";departmentType = 0;pixel_x = -30;pixel_y = 0},/obj/machinery/light{dir = 8},/turf/open/floor/plasteel,/area/quartermaster/miningdock)
"ag" = (/obj/structure/chair/office/dark{dir = 8},/turf/open/floor/plasteel,/area/quartermaster/miningdock)
"ah" = (/obj/structure/disposalpipe/segment{dir = 1;icon_state = "pipe-c"},/obj/structure/cable/yellow{d1 = 1;d2 = 4;icon_state = "1-4"},/obj/machinery/atmospherics/pipe/simple/supply/hidden,/turf/open/floor/plasteel,/area/quartermaster/miningdock)
"ai" = (/obj/structure/cable/yellow{d1 = 4;d2 = 8;icon_state = "4-8";pixel_x = 0},/obj/structure/disposalpipe/segment{dir = 4},/obj/machinery/atmospherics/pipe/manifold/scrubbers/hidden{tag = "icon-manifold-r-f (WEST)";dir = 8},/turf/open/floor/plasteel,/area/quartermaster/miningdock)
"aj" = (/obj/structure/cable/yellow{d1 = 4;d2 = 8;icon_state = "4-8";pixel_x = 0},/obj/structure/disposalpipe/segment{dir = 4},/obj/machinery/atmospherics/pipe/simple/scrubbers/hidden{dir = 4},/turf/open/floor/plasteel,/area/quartermaster/miningdock)
"ak" = (/obj/machinery/door/airlock/maintenance{name = "Mining Maintenance";req_access_txt = "48"},/obj/structure/disposalpipe/segment{dir = 4},/obj/structure/cable/yellow{d1 = 4;d2 = 8;icon_state = "4-8";pixel_x = 0},/obj/machinery/atmospherics/pipe/simple/scrubbers/hidden{dir = 4},/turf/open/floor/plating,/area/quartermaster/miningdock)
"al" = (/obj/structure/grille,/obj/structure/window/shuttle,/turf/open/floor/plating,/area/shuttle/miningasteroid)
"am" = (/turf/closed/wall/shuttle{icon_state = "swall12";dir = 2},/area/shuttle/miningasteroid)
"an" = (/turf/open/space,/turf/closed/wall/shuttle{dir = 2;icon_state = "swall_f10";layer = 2},/area/shuttle/miningasteroid)
"ao" = (/obj/structure/sign/securearea{desc = "A warning sign which reads 'EXTERNAL AIRLOCK'";icon_state = "space";layer = 4;name = "EXTERNAL AIRLOCK";pixel_x = 0},/turf/closed/wall,/area/quartermaster/miningdock)
"ap" = (/obj/machinery/camera{c_tag = "Mining Dock";dir = 4;network = list("SS13")},/obj/machinery/light{icon_state = "tube1";dir = 8},/obj/machinery/computer/shuttle/miningasteroid,/turf/open/floor/plasteel,/area/quartermaster/miningdock)
"aq" = (/obj/machinery/atmospherics/pipe/simple/supply/hidden{dir = 5},/turf/open/floor/plasteel,/area/quartermaster/miningdock)
"ar" = (/obj/machinery/atmospherics/pipe/simple/supply/hidden{dir = 4},/obj/machinery/atmospherics/pipe/simple/scrubbers/hidden,/turf/open/floor/plasteel,/area/quartermaster/miningdock)
"as" = (/obj/machinery/airalarm{dir = 8;icon_state = "alarm0";pixel_x = 24},/obj/machinery/atmospherics/pipe/simple/supply/hidden{dir = 4},/turf/open/floor/plasteel,/area/quartermaster/miningdock)
"at" = (/obj/machinery/atmospherics/pipe/simple/supply/hidden{dir = 4},/turf/closed/wall,/area/quartermaster/miningdock)
"au" = (/obj/machinery/computer/shuttle/miningasteroid,/turf/open/floor/plasteel/shuttle,/area/shuttle/miningasteroid)
"av" = (/obj/structure/closet/crate,/turf/open/floor/plasteel/shuttle,/area/shuttle/miningasteroid)
"aw" = (/obj/machinery/light{dir = 1},/obj/structure/chair,/turf/open/floor/plasteel/shuttle,/area/shuttle/miningasteroid)
"ax" = (/obj/structure/chair,/turf/open/floor/plasteel/shuttle,/area/shuttle/miningasteroid)
"ay" = (/turf/open/floor/plasteel/shuttle,/area/shuttle/miningasteroid)
"az" = (/obj/machinery/door/airlock/shuttle{name = "Mining Shuttle Airlock";req_access_txt = "48"},/turf/open/floor/plasteel/shuttle,/area/shuttle/miningasteroid)
"aA" = (/obj/machinery/door/airlock/external{name = "Mining Dock Airlock";req_access = null;req_access_txt = "48"},/turf/open/floor/plating,/area/quartermaster/miningdock)
"aB" = (/turf/open/floor/plating,/area/quartermaster/miningdock)
"aC" = (/obj/machinery/door/airlock/glass_mining{name = "Mining Dock";req_access_txt = "48"},/turf/open/floor/plating,/area/quartermaster/miningdock)
"aD" = (/turf/open/floor/plasteel,/area/quartermaster/miningdock)
"aE" = (/obj/machinery/atmospherics/components/unary/vent_scrubber{dir = 4;on = 1;scrub_N2O = 0;scrub_Toxins = 0},/turf/open/floor/plasteel,/area/quartermaster/miningdock)
"aF" = (/obj/machinery/atmospherics/pipe/simple/scrubbers/hidden{dir = 4},/turf/open/floor/plasteel,/area/quartermaster/miningdock)
"aG" = (/obj/effect/landmark/start{name = "Shaft Miner"},/obj/machinery/atmospherics/pipe/simple/scrubbers/hidden{dir = 9},/turf/open/floor/plasteel,/area/quartermaster/miningdock)
"aH" = (/obj/structure/closet/secure_closet/miner,/turf/open/floor/plasteel,/area/quartermaster/miningdock)
"aI" = (/turf/closed/wall/shuttle{icon_state = "swall3";dir = 2},/area/shuttle/miningasteroid)
"aJ" = (/obj/structure/chair{dir = 1},/turf/open/floor/plasteel/shuttle,/area/shuttle/miningasteroid)
"aK" = (/obj/docking_port/mobile{dir = 8;dwidth = 4;height = 7;id = "miningasteroid";name = "mining shuttle";travelDir = 90;width = 7},/obj/docking_port/stationary{dir = 8;dwidth = 4;height = 7;id = "mining_home";name = "mining shuttle bay";width = 7},/obj/machinery/door/airlock/shuttle{name = "Mining Shuttle Airlock";req_access_txt = "48"},/turf/open/floor/plasteel/shuttle,/area/shuttle/miningasteroid)
"aL" = (/obj/effect/landmark/event_spawn,/turf/open/floor/plasteel,/area/quartermaster/miningdock)
"aM" = (/obj/effect/landmark/start{name = "Shaft Miner"},/turf/open/floor/plasteel,/area/quartermaster/miningdock)
"aN" = (/obj/structure/chair{dir = 4},/turf/open/floor/plasteel/shuttle,/area/shuttle/miningasteroid)
"aO" = (/obj/structure/ore_box,/turf/open/floor/plasteel/shuttle,/area/shuttle/miningasteroid)
"aP" = (/obj/machinery/light{dir = 1},/turf/closed/wall,/area/quartermaster/miningdock)
"aQ" = (/obj/structure/closet/secure_closet/miner,/obj/machinery/light{dir = 4;icon_state = "tube1"},/turf/open/floor/plasteel,/area/quartermaster/miningdock)
"aR" = (/obj/structure/chair{dir = 1},/obj/machinery/light,/turf/open/floor/plasteel/shuttle,/area/shuttle/miningasteroid)
"aS" = (/obj/structure/grille,/obj/structure/window/reinforced/fulltile,/turf/open/floor/plating,/area/quartermaster/miningdock)
"aT" = (/obj/machinery/computer/crew,/turf/open/floor/plasteel/whiteblue/side{tag = "icon-whiteblue (NORTHWEST)";icon_state = "whiteblue";dir = 9},/area/quartermaster/miningdock)
"aU" = (/obj/structure/chair/office/dark{dir = 8},/turf/open/floor/plasteel{dir = 1;icon_state = "whiteblue"},/area/quartermaster/miningdock)
"aV" = (/obj/machinery/door/airlock/glass_medical{id_tag = "MiningMedic";name = "Mining Medic";req_access_txt = "5"},/turf/open/floor/plasteel/white{baseturf = /turf/open/floor/plating/lava/smooth/lava_land_surface},/area/quartermaster/miningdock)
"aW" = (/obj/structure/shuttle/engine/propulsion{icon_state = "propulsion";dir = 4},/turf/open/floor/plating,/area/shuttle/miningasteroid)
"aX" = (/obj/structure/shuttle/engine/heater{icon_state = "heater";dir = 8},/turf/closed/wall/shuttle{icon_state = "swallc2";dir = 2},/area/shuttle/miningasteroid)
"aY" = (/obj/structure/shuttle/engine/heater,/turf/closed/wall/shuttle{icon_state = "swall12";dir = 2},/area/shuttle/miningasteroid)
"aZ" = (/obj/structure/shuttle/engine/heater{icon_state = "heater";dir = 4},/turf/closed/wall/shuttle{icon_state = "swallc1"},/area/shuttle/miningasteroid)
"ba" = (/obj/structure/shuttle/engine/propulsion{icon_state = "propulsion";dir = 8},/turf/open/floor/plating,/area/shuttle/miningasteroid)
"bb" = (/obj/structure/closet/secure_closet/mmedical,/turf/open/floor/plasteel{dir = 8;icon_state = "whiteblue"},/area/quartermaster/miningdock)
"bc" = (/obj/effect/landmark/start{name = "Mining Medic"},/obj/machinery/light{dir = 4;icon_state = "tube1"},/turf/open/floor/plasteel/white{baseturf = /turf/open/floor/plating/lava/smooth/lava_land_surface},/area/quartermaster/miningdock)
"bd" = (/obj/structure/closet/wardrobe/miner,/turf/open/floor/plasteel{dir = 2;icon_state = "brown"},/area/quartermaster/miningdock)
"be" = (/obj/structure/tank_dispenser/oxygen,/turf/open/floor/plasteel{dir = 2;icon_state = "brown"},/area/quartermaster/miningdock)
"bf" = (/obj/machinery/mineral/equipment_vendor,/turf/open/floor/plasteel{dir = 2;icon_state = "brown"},/area/quartermaster/miningdock)
"bg" = (/obj/effect/landmark/start{name = "Shaft Miner"},/turf/open/floor/plasteel{dir = 2;icon_state = "brown"},/area/quartermaster/miningdock)
"bh" = (/obj/structure/closet/secure_closet/miner,/turf/open/floor/plasteel{dir = 2;icon_state = "brown"},/area/quartermaster/miningdock)
"bi" = (/turf/open/space,/turf/closed/wall/shuttle{icon_state = "swall_f5";dir = 2},/area/shuttle/miningasteroid)
"bj" = (/turf/closed/wall/shuttle{icon_state = "swallc4";dir = 2},/area/shuttle/miningasteroid)
"bk" = (/obj/structure/shuttle/engine/propulsion{icon_state = "propulsion_l"},/turf/open/floor/plating,/area/shuttle/miningasteroid)
"bl" = (/obj/structure/shuttle/engine/propulsion,/turf/open/floor/plating,/area/shuttle/miningasteroid)
"bm" = (/obj/structure/shuttle/engine/propulsion{icon_state = "propulsion_r"},/turf/open/floor/plating,/area/shuttle/miningasteroid)
"bn" = (/turf/closed/wall/shuttle{icon_state = "swallc3"},/area/shuttle/miningasteroid)
"bo" = (/turf/open/space,/turf/closed/wall/shuttle{icon_state = "swall_f9";dir = 2},/area/shuttle/miningasteroid)
"bp" = (/obj/machinery/suit_storage_unit/mmedic,/turf/open/floor/plasteel{dir = 10;icon_state = "whiteblue"},/area/quartermaster/miningdock)
"bq" = (/turf/open/floor/plasteel{dir = 2;icon_state = "whiteblue"},/area/quartermaster/miningdock)
"br" = (/turf/open/floor/plating/airless{dir = 1;icon_state = "warnplate"},/area/space)

(1,1,1) = {"
aaababacababaaadadadaeafagahaiajak
alalalamamamanaeaeaoaeapagaqarasat
alauavawaxayazaAaBaCaDaDaEaFaGaHae
aIaJayayayayaKaAaBaCaDaDaLaDaMaHae
aIaNayayayaOaIaeaeaeaPaDaDaDaMaQae
aIaNaOaRaJavaIaSaTaUaVaDaDaDaMaHae
aWaXaYaYaYaZbaaSbbbcaebdbebfbgbhae
bibjbkblbmbnboaebpbqaeaeaeaeaeaeae
aabrbrbrbrbraaaeaeaeaeadadadadadad
"}
