"aa" = (/turf/open/floor/plating/airless,/area/space)
"ab" = (/turf/open/floor/plating/airless{dir = 2;icon_state = "warnplate"},/area/space)
"ac" = (/obj/structure/sign/securearea{desc = "A warning sign which reads 'KEEP CLEAR OF DOCKING AREA'.";name = "KEEP CLEAR: DOCKING AREA";pixel_y = 32},/turf/open/floor/plating/airless{dir = 2;icon_state = "warnplate"},/area/space)
"ad" = (/obj/structure/lattice,/turf/open/space,/area/space)
"ae" = (/turf/open/space,/area/space)
"af" = (/turf/closed/wall,/area/quartermaster/miningdock)
"ag" = (/obj/structure/table,/obj/item/weapon/folder/yellow,/obj/item/weapon/pen,/obj/machinery/requests_console{department = "Mining";departmentType = 0;pixel_x = -30;pixel_y = 0},/obj/machinery/light{dir = 8},/turf/open/floor/plasteel,/area/quartermaster/miningdock)
"ah" = (/obj/structure/chair/office/dark{dir = 8},/obj/effect/landmark/start{name = "Shaft Miner"},/turf/open/floor/plasteel,/area/quartermaster/miningdock)
"ai" = (/obj/structure/disposalpipe/segment{dir = 1;icon_state = "pipe-c"},/obj/structure/cable/yellow{d1 = 1;d2 = 4;icon_state = "1-4"},/obj/machinery/atmospherics/pipe/simple/supply/hidden,/turf/open/floor/plasteel,/area/quartermaster/miningdock)
"aj" = (/obj/structure/cable/yellow{d1 = 4;d2 = 8;icon_state = "4-8";pixel_x = 0},/obj/structure/disposalpipe/segment{dir = 4},/obj/machinery/atmospherics/pipe/manifold/scrubbers/hidden{tag = "icon-manifold-r-f (WEST)";dir = 8},/turf/open/floor/plasteel,/area/quartermaster/miningdock)
"ak" = (/obj/structure/cable/yellow{d1 = 4;d2 = 8;icon_state = "4-8";pixel_x = 0},/obj/structure/disposalpipe/segment{dir = 4},/obj/machinery/atmospherics/pipe/simple/scrubbers/hidden{dir = 4},/turf/open/floor/plasteel,/area/quartermaster/miningdock)
"al" = (/obj/machinery/door/airlock/maintenance{name = "Mining Maintenance";req_access_txt = "48"},/obj/structure/disposalpipe/segment{dir = 4},/obj/structure/cable/yellow{d1 = 4;d2 = 8;icon_state = "4-8";pixel_x = 0},/obj/machinery/atmospherics/pipe/simple/scrubbers/hidden{dir = 4},/turf/open/floor/plating,/area/quartermaster/miningdock)
"am" = (/turf/open/space,/turf/closed/wall/shuttle{icon_state = "swall_f6";dir = 2},/area/shuttle/labor)
"an" = (/turf/closed/wall/shuttle{icon_state = "swall12";dir = 2},/area/shuttle/labor)
"ao" = (/obj/structure/grille,/obj/structure/window/shuttle,/turf/open/floor/plating,/area/shuttle/labor)
"ap" = (/turf/open/space,/turf/closed/wall/shuttle{dir = 2;icon_state = "swall_f10";layer = 2},/area/shuttle/labor)
"aq" = (/obj/machinery/computer/security/mining,/obj/machinery/camera{c_tag = "Mining Dock";dir = 4;network = list("SS13")},/turf/open/floor/plasteel,/area/quartermaster/miningdock)
"ar" = (/turf/open/floor/plasteel,/area/quartermaster/miningdock)
"as" = (/obj/machinery/atmospherics/pipe/simple/supply/hidden{dir = 5},/turf/open/floor/plasteel,/area/quartermaster/miningdock)
"at" = (/obj/machinery/atmospherics/pipe/simple/supply/hidden{dir = 4},/obj/machinery/atmospherics/pipe/simple/scrubbers/hidden,/obj/effect/landmark/start{name = "Shaft Miner"},/turf/open/floor/plasteel,/area/quartermaster/miningdock)
"au" = (/obj/machinery/airalarm{dir = 8;icon_state = "alarm0";pixel_x = 24},/obj/machinery/atmospherics/pipe/simple/supply/hidden{dir = 4},/obj/structure/closet/secure_closet/miner,/turf/open/floor/plasteel,/area/quartermaster/miningdock)
"av" = (/obj/machinery/atmospherics/pipe/simple/supply/hidden{dir = 4},/turf/closed/wall,/area/quartermaster/miningdock)
"aw" = (/turf/closed/wall/shuttle{icon_state = "swall3";dir = 2},/area/shuttle/labor)
"ax" = (/obj/structure/table,/turf/open/floor/plasteel/shuttle,/area/shuttle/labor)
"ay" = (/obj/machinery/computer/shuttle/mining,/turf/open/floor/plasteel/shuttle,/area/shuttle/labor)
"az" = (/obj/structure/grille,/obj/structure/window/reinforced/fulltile,/turf/open/floor/plating,/area/quartermaster/miningdock)
"aA" = (/obj/machinery/computer/shuttle/mining,/turf/open/floor/plasteel{dir = 9;icon_state = "brown"},/area/quartermaster/miningdock)
"aB" = (/obj/machinery/atmospherics/components/unary/vent_scrubber{dir = 4;on = 1;scrub_N2O = 0;scrub_Toxins = 0},/turf/open/floor/plasteel,/area/quartermaster/miningdock)
"aC" = (/obj/machinery/atmospherics/pipe/simple/scrubbers/hidden{dir = 4},/turf/open/floor/plasteel,/area/quartermaster/miningdock)
"aD" = (/obj/effect/landmark/start{name = "Shaft Miner"},/obj/machinery/atmospherics/pipe/simple/scrubbers/hidden{dir = 9},/turf/open/floor/plasteel,/area/quartermaster/miningdock)
"aE" = (/obj/structure/closet/secure_closet/miner,/turf/open/floor/plasteel,/area/quartermaster/miningdock)
"aF" = (/obj/structure/chair{dir = 1},/turf/open/floor/plasteel/shuttle,/area/shuttle/labor)
"aG" = (/obj/item/weapon/ore/iron,/turf/open/floor/plasteel{dir = 9;icon_state = "warning"},/area/quartermaster/miningdock)
"aH" = (/obj/structure/closet/crate,/obj/machinery/light/small{dir = 4},/obj/item/device/radio/intercom{dir = 4;name = "Station Intercom (General)";pixel_x = 27},/turf/open/floor/plasteel{dir = 1;icon_state = "warning"},/area/quartermaster/miningdock)
"aI" = (/turf/open/floor/plasteel{dir = 8;icon_state = "brown"},/area/quartermaster/miningdock)
"aJ" = (/obj/effect/landmark/start{name = "Shaft Miner"},/turf/open/floor/plasteel,/area/quartermaster/miningdock)
"aK" = (/turf/open/floor/plasteel/shuttle,/area/shuttle/labor)
"aL" = (/obj/machinery/door/airlock/shuttle{name = "Mining Shuttle Airlock";req_access_txt = "48"},/obj/docking_port/mobile{dir = 8;dwidth = 3;height = 5;id = "mining";name = "mining shuttle";travelDir = 90;width = 7},/obj/docking_port/stationary{dir = 8;dwidth = 3;height = 5;id = "mining_home";name = "mining shuttle bay";width = 7},/turf/open/floor/plating,/area/shuttle/labor)
"aM" = (/obj/machinery/door/airlock/external{name = "Mining Dock Airlock";req_access = null;req_access_txt = "48"},/turf/open/floor/plating,/area/quartermaster/miningdock)
"aN" = (/obj/machinery/door/airlock/glass_mining{name = "Mining Dock";req_access_txt = "48"},/turf/open/floor/plasteel,/area/quartermaster/miningdock)
"aO" = (/obj/effect/landmark/event_spawn,/turf/open/floor/plasteel,/area/quartermaster/miningdock)
"aP" = (/obj/item/weapon/ore/silver,/obj/item/weapon/ore/silver,/turf/open/floor/plasteel{dir = 10;icon_state = "warning"},/area/quartermaster/miningdock)
"aQ" = (/obj/machinery/camera{c_tag = "Mining Dock External";dir = 8},/obj/structure/reagent_dispensers/fueltank,/turf/open/floor/plasteel{icon_state = "warning"},/area/quartermaster/miningdock)
"aR" = (/obj/structure/sign/securearea{desc = "A warning sign which reads 'EXTERNAL AIRLOCK'";icon_state = "space";layer = 4;name = "EXTERNAL AIRLOCK";pixel_x = 0},/turf/closed/wall,/area/quartermaster/miningdock)
"aS" = (/obj/structure/closet/emcloset,/turf/open/floor/plasteel{dir = 10;icon_state = "brown"},/area/quartermaster/miningdock)
"aT" = (/obj/structure/closet/wardrobe/miner,/turf/open/floor/plasteel,/area/quartermaster/miningdock)
"aU" = (/obj/effect/landmark/start{name = "Mining Medic"},/turf/open/floor/plasteel,/area/quartermaster/miningdock)
"aV" = (/obj/machinery/mineral/equipment_vendor,/turf/open/floor/plasteel,/area/quartermaster/miningdock)
"aW" = (/obj/structure/closet/crate,/turf/open/floor/plasteel/shuttle,/area/shuttle/labor)
"aX" = (/obj/structure/shuttle/engine/heater,/turf/open/floor/plating,/area/shuttle/labor)
"aY" = (/obj/structure/ore_box,/turf/open/floor/plasteel/shuttle,/area/shuttle/labor)
"aZ" = (/turf/open/space,/turf/closed/wall/shuttle{icon_state = "swall_f5";dir = 2},/area/shuttle/labor)
"ba" = (/obj/structure/shuttle/engine/propulsion/burst,/obj/structure/window/reinforced{dir = 1;layer = 2.9},/turf/open/floor/plating/airless,/area/shuttle/labor)
"bb" = (/turf/open/space,/turf/closed/wall/shuttle{icon_state = "swall_f9";dir = 2},/area/shuttle/labor)
"bc" = (/turf/open/floor/plating/airless{dir = 1;icon_state = "warnplate"},/area/space)

(1,1,1) = {"
aaababacababaaadaeaeafagahaiajakal
aeamanaoanapaeadaeafafaqarasatauav
aeawaxayaxawazazazafaAaraBaCaDaEaf
aeaoaFaFaFaoazaGaHafaIaraJararaEaf
aeawaKaKaKaLaMararaNaIarararaOaEaf
aeaoaFaFaFaoazaPaQaRaSaTaUaVaJaEaf
aeawaWaXaYawazazazafafafafafafafaf
aeaZanbaanbbaeadaeaeaeaeaeaeaeaeae
aabcbcbcbcbcaaadaeaeaeaeaeaeaeaeae
"}
